dixieland	Concept
regional blues	Concept
hard rock	Concept
tarantella	Concept
Queen	Entity
Shamrock Diaries	Entity
concertos	Concept
Liz Phair	Entity
Katy Perry	Entity
air	Concept
keyed trumpet	Concept
Lose My Breath	Entity
finale	Concept
Heart Food	Entity
excerpt	Concept
cool jazz	Concept
Pennywise	Entity
post hardcore	Concept
conductor	Concept
Annie Lennox	Entity
epistle	Concept
clavichord	Concept
psytrance	Concept
intro	Concept
turntablists	Concept
Boy George	Entity
tenor	Concept
sitar	Concept
folk ballad	Concept
tuba	Concept
trombone	Concept
plainsong	Concept
wedding music	Concept
theremin	Concept
cacophony	Concept
Coil	Entity
progressive metal	Concept
national anthem	Concept
leitmotiv	Concept
study	Concept
David Bisbal	Entity
toccata	Concept
east coast	Concept
reel	Concept
Photograph	Entity
rhythm and blues	Concept
krautrock	Concept
lullabies	Concept
Bob Dylan	Entity
For Sleepyheads Only	Entity
sarabande	Concept
popular music	Concept
neotraditional	Concept
salutation	Concept
Thornography	Entity
blues	Concept
art rock	Concept
traditional folk	Concept
sextets	Concept
rock	Concept
serialism	Concept
stride piano	Concept
Velvet Monkeys	Entity
Supraphon	Entity
short form	Concept
crooning	Concept
ska punk	Concept
quartet	Concept
british punk	Concept
Yankee Hotel Foxtrot	Entity
marimba	Concept
The Rolling Stones	Entity
potpourri	Concept
a cappella singing	Concept
Renaissance music	Concept
alphorn	Concept
roots rock	Concept
electronic	Concept
ocarina	Concept
vamp	Concept
country and western	Concept
voice	Concept
figured bass	Concept
Never Say Die	Entity
sonatina	Concept
Naked	Entity
folksong	Concept
quote	Concept
movie soundtrack	Concept
Rolling Stones	Entity
sonata	Concept
duette	Concept
antiphonal	Concept
Über	Entity
bugle	Concept
fado	Concept
Fallen	Entity
accompaniment	Concept
neo-soul	Concept
Gittler guitar	Concept
new wave	Concept
jump blues	Concept
swing music	Concept
motif	Concept
bassoon	Concept
kick drum	Concept
Salvation	Entity
chorale	Concept
symphonic music	Concept
Russian pop	Concept
gospel singing	Concept
Christian rock	Concept
french pop	Concept
minstrelsy	Concept
rock and roll	Concept
Wrapped Around	Entity
Latin jazz	Concept
claves	Concept
trio	Concept
baritone saxophone	Concept
drum & bass	Concept
clarinette basse	Concept
jamaican ska	Concept
vocalizing	Concept
military music	Concept
Edwin Birdsong	Entity
Salvatore Adamo	Entity
Metallica	Entity
instrumentation	Concept
goth	Concept
cutting	Concept
epilogue	Concept
Angels Fall First	Entity
Kaleidoscope	Entity
Mute Print	Entity
The Cure	Entity
reggaeton	Concept
Whip My Hair	Entity
harmonisation	Concept
musical drama	Concept
orchestra	Concept
funk	Concept
psalm	Concept
incidental music	Concept
opening	Concept
cadence	Concept
glockenspiel	Concept
modern jazz	Concept
serious music	Concept
radio shows	Concept
preparation	Concept
cantus firmus	Concept
rock opera	Concept
Tool	Entity
Ilosaarirock	Entity
kickdrum	Concept
autoharp	Concept
Judas Priest	Entity
recitative	Concept
Good Vibrations	Entity
Brazilian rock	Concept
chant	Concept
pedal	Concept
Your Favorite Weapon	Entity
Pink Floyd	Entity
musical passage	Concept
gregorian chant	Concept
irish folk	Concept
voices	Concept
support	Concept
musical composition	Concept
drinking song	Concept
fiddle	Concept
glissando	Concept
drum cadence	Concept
invention	Concept
inversion	Concept
slide	Concept
Madonna	Entity
Summertime	Entity
sheng	Concept
Grateful Dead	Entity
tambourine	Concept
Hollywood	Entity
lieder	Concept
Marbles	Entity
Handbags and Gladrags	Entity
descant	Concept
duo	Concept
The Ultimate	Entity
rap	Concept
jangle pop	Concept
Black Sabbath	Entity
Cypress Hill	Entity
alternative rock	Concept
bachata	Concept
shock rock	Concept
Deep Purple	Entity
strain	Concept
zydeco	Concept
piano music	Concept
tone poems	Concept
tenor saxophone	Concept
monody	Concept
keyboardist	Concept
psalmody	Concept
soprano saxophone	Concept
allegro	Concept
doo-wop	Concept
rock'n'roll	Concept
punk	Concept
adult alternative	Concept
Hockey	Entity
musical	Concept
percussion	Concept
Jim O'Rourke	Entity
cantata	Concept
grand opera	Concept
symphonic poem	Concept
Stravinsky	Entity
part	Concept
Loaded	Entity
bel canto	Concept
alternative metal	Concept
Les Claypool	Entity
lament	Concept
Seraphim	Entity
My My	Entity
grand piano	Concept
choral	Concept
transverse flute	Concept
harmonium	Concept
drumming	Concept
bass clarinet	Concept
guitar gods	Concept
Elton John	Entity
The Crusade	Entity
vocal jazz	Concept
movement	Concept
Mikey Chung	Entity
French rock	Concept
british invasion	Concept
soundtrack album	Concept
Pearl Jam	Entity
postlude	Concept
Joy Division	Entity
heavy metal music	Concept
motive	Concept
antiphonary	Concept
indie rock	Concept
morceau	Concept
preface	Concept
swedish pop	Concept
Peter Gabriel	Entity
freestyle	Concept
Hot Mess	Entity
canons	Concept
Bruce Springsteen	Entity
Wagner	Entity
Smokey	Entity
Louis Armstrong	Entity
rockabilly	Concept
american punk	Concept
instrumental music	Concept
rocksteady	Concept
adult contemporary	Concept
foreword	Concept
caroling	Concept
Massive Attack	Entity
electronica	Concept
Art of Life	Entity
classic rock	Concept
ground	Concept
mouth organ	Concept
microphone	Concept
suspended cymbal	Concept
Prince	Entity
hymn	Concept
chamber music	Concept
rock guitarists	Concept
gospel	Concept
european jazz	Concept
bass part	Concept
symphony	Concept
black music	Concept
sheet music	Concept
banjo	Concept
chanting	Concept
Frank Sinatra	Entity
country	Concept
Some Kinda Rush	Entity
mandolin	Concept
theme song	Concept
Planningtorock	Entity
singsong	Concept
Indorock	Entity
Steve Mackey	Entity
Björk	Entity
Quincy Jones	Entity
rainstick	Concept
bugler	Concept
Dizzy Gillespie	Entity
acoustic blues	Concept
carol	Concept
chorus	Concept
passage	Concept
idm	Concept
solo	Concept
karaoke	Concept
sleigh bells	Concept
ambient	Concept
Nevermind	Entity
religious song	Concept
Avalon	Entity
baritone guitar	Concept
Stream of Consciousness	Entity
homophony	Concept
korean pop	Concept
twee pop	Concept
The Offspring	Entity
James Brown	Entity
bagpipe	Concept
zither	Concept
cittern	Concept
northern	Concept
Peace of Mind	Entity
harmonica	Concept
ambient pop	Concept
The Arrival	Entity
serial music	Concept
Nas	Entity
alto saxophone	Concept
bongo drum	Concept
math rock	Concept
David Bowie	Entity
coloratura	Concept
The War	Entity
songstress	Concept
Lollipop	Entity
twelve-tone music	Concept
obligato	Concept
negro spiritual	Concept
punk-pop	Concept
metal	Concept
Angela McCluskey	Entity
Jimi Hendrix	Entity
track	Concept
Backstreet Boys	Entity
baritone horn	Concept
bebop	Concept
songbook	Concept
musical score	Concept
fugue	Concept
threnody	Concept
hillbilly music	Concept
hardcore	Concept
electronic pop	Concept
pastiche	Concept
chantey	Concept
psychedelic rock	Concept
vocal	Concept
motown	Concept
love-song	Concept
octet	Concept
Rancid	Entity
Benny Goodman	Entity
Depeche Mode	Entity
cumbia	Concept
John Peel	Entity
Duran Duran	Entity
house	Concept
orchestration	Concept
melodic phrase	Concept
bell lyre	Concept
death metal	Concept
bass saxophone	Concept
Brian Eno	Entity
Charlotte Church	Entity
Sex Pistols	Entity
finger cymbals	Concept
surf guitar	Concept
plainchant	Concept
ragtime	Concept
celtic folk	Concept
rap music	Concept
After the Storm	Entity
punk rock	Concept
traditional pop	Concept
Genesis	Entity
Aphex Twin	Entity
odes	Concept
hornpipe	Concept
maracas	Concept
martial music	Concept
chorale prelude	Concept
transition	Concept
vibraphonist	Concept
primo	Concept
Kazimierz Serocki	Entity
spoken word	Concept
oldies	Concept
cabaret	Concept
blues rock	Concept
Beastie Boys	Entity
prelude	Concept
Group Therapy	Entity
sextet	Concept
carioca	Concept
Agoraphobia	Entity
alto flute	Concept
drumstick	Concept
Bounce	Entity
rap rock	Concept
The Whole Shebang	Entity
septet	Concept
snare drum	Concept
The Donkeys	Entity
garage rock	Concept
Robert Cray	Entity
Shakey Ground	Entity
triangle	Concept
Just Dance	Entity
southern gospel	Concept
flageolet	Concept
The Doldrums	Entity
traditional	Concept
Manners	Entity
Take Me Out	Entity
yodeling	Concept
trio sonata	Concept
latin rock	Concept
dance hall	Concept
train whistle	Concept
clapper	Concept
mbira	Concept
AKB48	Entity
chimes	Concept
The Magic Flute	Entity
Tony Brock	Entity
Planet Earth	Entity
Motörhead	Entity
suite	Concept
ostinato	Concept
vocal music	Concept
introit	Concept
tin whistle	Concept
scat	Concept
soul	Concept
cornet	Concept
Wu-Tang Clan	Entity
country rock	Concept
thumb piano	Concept
Eminem	Entity
AC/DC	Entity
Dreamtime	Entity
Carl Davis	Entity
latin pop	Concept
classical	Concept
Elvis Costello	Entity
horn	Concept
texas blues	Concept
sea chantey	Concept
torch song	Concept
anticlimax	Concept
lyricist	Concept
harmonization	Concept
The Smiths	Entity
bongo drums	Concept
improvisation	Concept
ballroom music	Concept
pavan	Concept
sing-a-longs	Concept
folk music	Concept
crumhorn	Concept
Antichrist Superstar	Entity
partita	Concept
whistling	Concept
Sepultura	Entity
musical arrangement	Concept
southern rap	Concept
gradual	Concept
heavy metal	Concept
Pakistani rock	Concept
doo wop	Concept
barcarolle	Concept
euphony	Concept
samba	Concept
elegies	Concept
rondo	Concept
outlaw country	Concept
jazz fusion	Concept
arioso	Concept
bluegrass	Concept
The Beach Boys	Entity
flute	Concept
Ascendancy	Entity
choir	Concept
Mike Hickey	Entity
rave	Concept
duet	Concept
