alluvium	Concept
roundhouse	Concept
Willamette University	Entity
amazon	Concept
infrastructure	Concept
smut	Concept
palm	Concept
teleportation	Concept
hurdling	Concept
outfielder	Concept
chuck steak	Concept
habit	Concept
medical emergency	Concept
lemon verbena	Concept
lunation	Concept
Half-Life	Entity
Poeciliopsis	Concept
pollock	Concept
Gabriel Guerra	Entity
sailing ship	Concept
Chromosome 9	Entity
smoothbore	Concept
patent	Concept
Erna Brodber	Entity
Fudan University	Entity
policy	Concept
anal sex	Concept
Vilfredo Pareto	Entity
links	Concept
Franco Corelli	Entity
shirt	Concept
praise	Concept
newsletter	Concept
preparation	Concept
Deutschland	Entity
Jimmy Tingle	Entity
roe	Concept
bunionectomy	Concept
aquamarine	Concept
graduate	Concept
chopper	Concept
atmosphere	Concept
consigner	Concept
power	Concept
savoy	Concept
Joe Price	Entity
lunchtime	Concept
Magnificent Mile	Entity
Local Group	Entity
spinneret	Concept
