whoredom	Concept
flavin	Concept
excommunication	Concept
El Mercurio	Entity
roundhouse	Concept
liquid	Concept
praetor	Concept
specialist	Concept
sodium nitrite	Concept
in-joke	Concept
road rage	Concept
interpellation	Concept
pellicle	Concept
metre	Concept
St. Augustine	Entity
Brady Smith	Entity
State Highway 17	Entity
treasure map	Concept
Amis	Concept
debt	Concept
nag	Concept
CISC	Concept
mentor	Concept
Dorothea Puente	Entity
diversity	Concept
Yellowstone Caldera	Entity
capital	Concept
hound	Concept
Gagandeep Singh	Entity
Panthera pardus	Concept
Richard Kuklinski	Entity
sulfur dioxide	Concept
first lady	Concept
downtime	Concept
overpass	Concept
trust company	Concept
Walter Boyce	Entity
magnet	Concept
payoff	Concept
balsa raft	Concept
Aram I	Entity
Talim	Entity
Sonora	Entity
Bobby Williams	Entity
putter	Concept
architecture	Concept
formula	Concept
storyteller	Concept
ordinary	Concept
flirting	Concept
