change-of-pace	Concept
sociology department	Concept
Yahoo	Entity
gusset	Concept
glutton	Concept
plumbing	Concept
Marcel Duchamp	Entity
flare	Concept
St. Bernard Software	Entity
gigahertz	Concept
Pacaya	Entity
report	Concept
Jehuda Reinharz	Entity
hybrid	Concept
recall	Concept
earl	Concept
Talim	Entity
life history	Concept
kink	Concept
turn	Concept
Pyrrhus	Entity
lira	Concept
judgment	Concept
hallelujah	Concept
police	Concept
Drawing Restraint 9	Entity
militarization	Concept
nu metal	Concept
Richard Kuklinski	Entity
diffusor	Concept
Muppet Babies	Entity
successor	Concept
Honeyd	Entity
Adams Express Company	Entity
Bill Douglass	Entity
VersionTracker	Entity
magnetometer	Concept
Iceland	Entity
teamster	Concept
John Drew	Entity
fat	Concept
Poland	Entity
restrictiveness	Concept
pecan	Concept
Whitaker	Entity
tortilla	Concept
Jon Clardy	Entity
tricolour	Concept
Graduate House	Entity
Jackson Zoo	Entity
