invalid	Concept
Hill cipher	Concept
troll	Concept
Jon Clardy	Entity
Tennessee	Entity
family therapy	Concept
philia	Concept
camelpox	Concept
recission	Concept
burr oak	Concept
Marienkirche	Entity
version	Concept
ground level	Concept
finalization	Concept
language	Concept
Deep learning	Concept
sliminess	Concept
Venus	Entity
sapphire	Concept
heller	Concept
conspiracy	Concept
Dublin Bus	Entity
counterpane	Concept
belfry	Concept
precognition	Concept
fleur-de-lis	Concept
Be Yourself	Entity
Callender	Entity
tax haven	Concept
knight-errant	Concept
sodium nitrite	Concept
byroad	Concept
S4	Concept
spinneret	Concept
Harold Volkmer	Entity
consumption	Concept
ossification	Concept
hunting	Concept
station	Concept
Touch and Go	Entity
far left	Concept
John Pankow	Entity
representative	Concept
Wakashan	Concept
scoutmaster	Concept
self-confidence	Concept
script	Concept
tomato soup	Concept
regulating	Concept
Typhoon Lupit	Entity
editor in chief	Concept
USS Shiloh	Entity
chauvinism	Concept
Dallas Cowboys Cheerleaders	Entity
counterclaim	Concept
currency	Concept
staff	Concept
hearsay rule	Concept
torsion	Concept
Josef Gingold	Entity
Alex Sink	Entity
Tim Dwight	Entity
enlistment	Concept
chapter	Concept
Dorion Sagan	Entity
IRA	Concept
inheritance	Concept
nonreader	Concept
deposition	Concept
William Jordan	Entity
Bill Koski	Entity
Azua	Entity
Asia	Entity
in-joke	Concept
wood	Concept
Eliezer Yudkowsky	Entity
blindfold	Concept
Stokes drift	Concept
workhouse	Concept
Mollie Katzen	Entity
psychokinesis	Concept
freethought	Concept
ruby	Concept
fine	Concept
regeneration	Concept
gamboge	Concept
lunchtime	Concept
Tropical Storm Erika	Entity
Grani	Entity
RELCOM	Entity
Seema Biswas	Entity
hell	Concept
science journalism	Concept
pension	Concept
escudo	Concept
burgh	Concept
augmentation	Concept
economic policy	Concept
defeat	Concept
marketing research	Concept
spectroscope	Concept
couture	Concept
acquittance	Concept
perpendicular	Concept
tragedy	Concept
faulting	Concept
health economics	Concept
Grimm	Entity
glade	Concept
gabardine	Concept
page	Concept
PlayStation Portable	Entity
Robert Trivers	Entity
milkwort	Concept
space	Concept
farm animal	Concept
photojournalism	Concept
Invermay	Entity
Denning	Entity
barley	Concept
Jane Asher	Entity
fifty	Concept
truffle	Concept
Sonora	Entity
Walter Boyce	Entity
authoress	Concept
synchronizer	Concept
escrow	Concept
natural resources	Concept
one-way street	Concept
vegetarian	Concept
Swami Haridas	Entity
Blithe Spirit	Entity
Wisconsin	Entity
workplace	Concept
Manarola	Entity
tableware	Concept
hyperboloid	Concept
praise	Concept
Aryabhata	Entity
windage	Concept
crumpet	Concept
tonne	Concept
Carlo Levi	Entity
triple	Concept
poet	Concept
gdbserver	Concept
RVF	Concept
laptop	Concept
subspecies	Concept
outflow	Concept
diffraction	Concept
accounting	Concept
Bierstadt	Entity
Elbridge Gerry	Entity
ball	Concept
successor	Concept
Bernina Express	Entity
documentary	Concept
transportation	Concept
Bomberman	Entity
Gainesville	Entity
life history	Concept
cribbage	Concept
USS Housatonic	Entity
Flo Ziegfeld	Entity
sitagliptin	Concept
watercraft	Concept
liquidation	Concept
WinSCP	Entity
Riverboat Discovery	Entity
policy	Concept
Aram I	Entity
rat-catcher	Concept
list	Concept
nail	Concept
male	Concept
department	Concept
school building	Concept
bank	Concept
serial	Concept
imputation	Concept
Young	Entity
La Dolce Musto	Entity
shock	Concept
Jackson Zoo	Entity
aerodrome	Concept
top side	Concept
Linum	Concept
confederation	Concept
tenement	Concept
margin	Concept
breeze	Concept
Larderello	Entity
turbofan	Concept
Niels Bohr	Entity
liberty	Concept
John Drew	Entity
Paul Lafargue	Entity
bottled water	Concept
hustler	Concept
Pinot blanc	Concept
index	Concept
newsagent	Concept
journal	Concept
Unix shell	Concept
sister	Concept
camera	Concept
Zimbabwean	Concept
Renata Kallosh	Entity
Manassas	Entity
letter	Concept
Osbert Sitwell	Entity
Boulder Creek	Entity
satoyama	Concept
Roald Amundsen	Entity
hosiery	Concept
bar	Concept
hypertext markup language	Concept
Amoy	Concept
Hermes	Entity
Amelia Earhart	Entity
highschool	Concept
tropical depression	Concept
student council	Concept
Funen	Entity
interface	Concept
prefix	Concept
elopement	Concept
Laksar	Entity
dance	Concept
slugger	Concept
fellah	Concept
ammonium	Concept
collegian	Concept
Pure Pinball	Entity
Jean Piaget	Entity
streptomycin	Concept
real estate	Concept
ultramicroscope	Concept
jacket	Concept
self-justification	Concept
parceling	Concept
University of California	Entity
doldrums	Concept
baker	Concept
iota	Concept
apparition	Concept
market value	Concept
Lisa See	Entity
search engine	Concept
North Carolina	Entity
styrofoam	Concept
Cherie Nowlan	Entity
Dhiren Barot	Entity
Washburn High School	Entity
outlaw	Concept
vicarious liability	Concept
colostrum	Concept
disservice	Concept
loaf	Concept
alb	Concept
air mass	Concept
greenmail	Concept
Magnificent Mile	Entity
bladder cancer	Concept
Phrygian cap	Concept
diorama	Concept
Minnamurra	Entity
DirectX	Entity
diameter	Concept
Yellowstone Caldera	Entity
Mjolnir	Entity
Austin	Entity
Union Station	Entity
lira	Concept
James Mason	Entity
ten thousand	Concept
Susannah Heschel	Entity
Korea	Entity
full stop	Concept
lepton	Concept
temperament	Concept
autoresponder	Concept
suer	Concept
Internet	Concept
Lucrezia Borgia	Entity
dinner	Concept
Tutankhamun	Entity
crisis	Concept
assist	Concept
H-Net	Entity
The Washington Post	Entity
suite	Concept
Bingley	Entity
Straight River	Entity
Montlake Bridge	Entity
machine	Concept
Susan Strasberg	Entity
Vat Phou	Entity
employee	Concept
aqueduct	Concept
sparerib	Concept
streptomyces	Concept
Blisland	Entity
Ernie	Entity
violet	Concept
strappado	Concept
escutcheon	Concept
snag	Concept
hydrogeology	Concept
lightning rod	Concept
malediction	Concept
journalism	Concept
Honeyd	Entity
enrollee	Concept
sloop	Concept
poundage	Concept
Nuptse	Entity
Tropical Storm Alpha	Entity
Irish	Entity
pin money	Concept
stubble	Concept
selective mutism	Concept
exercise	Concept
endeavour	Concept
sawmill	Concept
Yapese	Concept
James Nash	Entity
groundnut	Concept
adobe	Concept
Drawing Restraint 9	Entity
charlotte	Concept
peasant	Concept
Blindsight	Entity
stairway	Concept
pocketbook	Concept
pleurisy	Concept
shepherd	Concept
homeostasis	Concept
Unreal Engine	Entity
felicity	Concept
Wang Xin	Entity
Quebec	Entity
Turonian	Entity
wheeler	Concept
government	Concept
Prentice Hall	Entity
Hurricane Wilma	Entity
Constantius	Entity
small	Concept
euphemism	Concept
business concern	Concept
aquamarine	Concept
spinal fusion	Concept
tadpole	Concept
admittance	Concept
TV	Concept
Fruitlands	Entity
triumvirate	Concept
Transportation	Entity
neurologist	Concept
valuation	Concept
warlord	Concept
freight	Concept
intransitivity	Concept
Ernest Lehman	Entity
stonecutter	Concept
civil union	Concept
distributer	Concept
teleconference	Concept
spring	Concept
Before Dark	Entity
van	Concept
IBM 1620	Entity
militarization	Concept
time	Concept
logical thinking	Concept
Susan B. Anthony	Entity
portraitist	Concept
tartar	Concept
patrician	Concept
nuclear medicine	Concept
syzygy	Concept
mongoose	Concept
village	Concept
Mota	Entity
heedfulness	Concept
cancer	Concept
referee	Concept
editor	Concept
fils	Concept
waybill	Concept
religionism	Concept
knickers	Concept
nutrition	Concept
Maximum Carnage	Entity
working capital	Concept
hooded cloak	Concept
restrictiveness	Concept
driving	Concept
fox	Concept
jet stream	Concept
Dirac	Entity
subtropics	Concept
carbon	Concept
font	Concept
shirt	Concept
waistcoat	Concept
palette	Concept
DC	Concept
vulcanite	Concept
mechanics	Concept
Quercus ilex	Concept
Kazak	Concept
vindication	Concept
song thrush	Concept
Chevrolet SSR	Entity
guts	Concept
postdoc	Concept
cricket	Concept
BioCryst Pharmaceuticals	Entity
hero	Concept
wagoner	Concept
tortilla chip	Concept
comic	Concept
Uraniborg	Entity
giro	Concept
thermoregulation	Concept
tacking	Concept
posey	Concept
wave	Concept
recommendation	Concept
shtup	Concept
downtime	Concept
Federal Records	Entity
sneeze	Concept
RTLinux	Entity
Graduate House	Entity
solid	Concept
recycling	Concept
Leonardo da Vinci	Entity
Nsanje	Entity
Knowth	Entity
distribution	Concept
Winterthur	Entity
betaine	Concept
workingman	Concept
software suite	Concept
San Andreas	Entity
pasqueflower	Concept
macedonia	Concept
Queen Elizabeth	Entity
calmodulin	Concept
pet shop	Concept
gamesmanship	Concept
lava	Concept
Arthur Ashe	Entity
financial aid	Concept
walk	Concept
Johan Remkes	Entity
proprioception	Concept
carbon dioxide	Concept
IronPython	Entity
Dorothea Puente	Entity
kerchief	Concept
Tectonic	Entity
Sidney R. Yates	Entity
Hugoton	Entity
Tellico Reservoir	Entity
Paul Mellars	Entity
prexy	Concept
decaf	Concept
lost cause	Concept
sight	Concept
Stephanian	Entity
mestranol	Concept
smallpox virus	Concept
The Infinite Mind	Entity
John Barclay	Entity
operation	Concept
fire service	Concept
American Stock Exchange	Entity
Pink Dot	Entity
lynching	Concept
pafuramidine	Concept
Catholic	Concept
World War II	Entity
academician	Concept
D'Arcy Wentworth	Entity
autograph	Concept
Bob Beers	Entity
Copper oxide	Concept
cingulate gyrus	Concept
octillion	Concept
ghrelin	Concept
Mike Allen	Entity
paragraph	Concept
Mossbank	Entity
program	Concept
expiration date	Concept
Richard Starkey	Entity
Herman Melville	Entity
marquee	Concept
Rigveda	Entity
Tobaiwa Mudede	Entity
trade embargo	Concept
Charles Alexander	Entity
foster-child	Concept
bear	Concept
handful	Concept
cumulus	Concept
queenfish	Concept
coder	Concept
magnetometer	Concept
pottery	Concept
hypostasis	Concept
jammies	Concept
Tacitus	Entity
fence	Concept
incorporation	Concept
seal	Concept
blockade	Concept
Monty Python	Entity
field hospital	Concept
lunch	Concept
subway	Concept
happening	Concept
Leipzig	Entity
turnstile	Concept
bothy	Concept
Analytical Engine	Entity
Wilma Vaught	Entity
Saqqaq	Entity
carat	Concept
Jack Lengyel	Entity
Orlando Sentinel	Entity
feebleness	Concept
Dunbar	Entity
magnet school	Concept
bed rest	Concept
I-20	Entity
prerogative	Concept
Ian Bell	Entity
Nikon F5	Entity
slating	Concept
President Lyndon Johnson	Entity
killer	Concept
Hotel Europe	Entity
harrow	Concept
baby tears	Concept
quote	Concept
Helen of Troy	Entity
liquid	Concept
city wall	Concept
rheumatism	Concept
About.com	Entity
Cyclone Gafilo	Entity
flip-flops	Concept
Talim	Entity
developmental disability	Concept
Slowhand	Entity
weapon	Concept
explosion	Concept
Cinnamomum	Concept
lemongrass	Concept
turn	Concept
parents	Concept
European Parliament	Entity
investment	Concept
secular	Concept
Hurricane Epsilon	Entity
state of nature	Concept
Abutilon theophrasti	Concept
apple pie	Concept
world	Concept
Bevis Hillier	Entity
adventure	Concept
organ donor	Concept
Africa	Entity
mayweed	Concept
click	Concept
stack	Concept
Keshu	Entity
mycelium	Concept
decentralisation	Concept
budget	Concept
baba	Concept
StarCraft	Entity
catsuit	Concept
bush	Concept
transmission	Concept
attic	Concept
penetrator	Concept
Don Baldwin	Entity
Jon Cassar	Entity
Jeff Francis	Entity
penis bone	Concept
society	Concept
Eteocles	Entity
dunce cap	Concept
burning	Concept
yesterday	Concept
Rheal Cormier	Entity
William S. Harney	Entity
German mark	Concept
ideal gas	Concept
larder	Concept
stucco	Concept
supermajority	Concept
Barney Bigard	Entity
czar	Concept
Dalbergia melanoxylon	Concept
leaf curl	Concept
prepositional phrase	Concept
excommunication	Concept
actuator	Concept
psychopathology	Concept
jingoism	Concept
collage	Concept
jerky	Concept
designer	Concept
Typhoon Saomai	Entity
Leon Festinger	Entity
army	Concept
Sino-Japanese War	Entity
La Veta Pass	Entity
épée	Concept
balk	Concept
Angostura Reservoir	Entity
radio	Concept
Dodie Bellamy	Entity
gorget	Concept
Zelda	Entity
change-of-pace	Concept
tempestuousness	Concept
etymologizing	Concept
grandee	Concept
waiver	Concept
unloading	Concept
oculist	Concept
newsprint	Concept
confederacy	Concept
rap music	Concept
Republic of Turkey	Entity
autocracy	Concept
blackfly	Concept
sport shirt	Concept
magazine	Concept
Qarbon	Entity
Rome	Entity
Tim Tebow	Entity
northwester	Concept
bramble	Concept
Agrippina	Entity
ulnar artery	Concept
Semipalatinsk Test Site	Entity
insignia	Concept
dragnet	Concept
David Ball	Entity
battle of Leuctra	Entity
sunspot	Concept
pumpkin	Concept
purslane	Concept
wine	Concept
French Broad River	Entity
microcontroller	Concept
stater	Concept
passage	Concept
smew	Concept
word	Concept
flooring	Concept
lion	Concept
Serpens Caput	Entity
Mohammad Yousuf	Entity
Leonhard Euler	Entity
disc	Concept
Sphagnum	Concept
Keats House	Entity
John Hodiak	Entity
country	Concept
footman	Concept
Typhoon Muifa	Entity
minors	Concept
hacksaw	Concept
cricketer	Concept
tricolour	Concept
Tropical Storm Helene	Entity
Parveen Babi	Entity
minute	Concept
extramarital sex	Concept
Sachs Harbour	Entity
Leonidas	Entity
maple leaf	Concept
Bergen	Entity
Maryland	Entity
cricopharyngeus	Concept
Howard K. Smith	Entity
carting	Concept
September	Entity
haloalkane	Concept
frame	Concept
Giovanni Bellini	Entity
Solent	Entity
appearing	Concept
King	Entity
track	Concept
gluon	Concept
bolster	Concept
tooth	Concept
relevancy	Concept
mackerel	Concept
Messi	Entity
Hamlet	Entity
tundra swan	Concept
award	Concept
Robert Frost	Entity
dashi	Concept
conversion	Concept
climate	Concept
spondee	Concept
halfpenny	Concept
roomette	Concept
reminiscence	Concept
Erna Brodber	Entity
Lutyens	Entity
Compact Muon Solenoid	Entity
broiler chicken	Concept
verbal abuse	Concept
rotter	Concept
designation	Concept
conditionality	Concept
Iran	Entity
covenant	Concept
Test Site	Entity
liquid nitrogen	Concept
Nubian	Concept
chestnut	Concept
Grosgrain	Concept
Hansel	Entity
Haven	Entity
Mohave Community College	Entity
ewe	Concept
community	Concept
Valetta	Entity
swashbuckler	Concept
proton pump	Concept
children	Concept
tortilla	Concept
Greek	Entity
owner	Concept
twinjet	Concept
Platt	Entity
bartlett	Concept
dike	Concept
dwarf planet	Concept
Robert Solow	Entity
oat	Concept
Windows	Entity
Brown	Entity
eschaton	Concept
molecule	Concept
Roy Hattersley	Entity
Surjit Singh Barnala	Entity
palomino	Concept
Melk	Entity
diversity	Concept
business software	Concept
precision	Concept
pollock	Concept
madam	Concept
Prentiss	Entity
cornstarch	Concept
dual carriageway	Concept
customs	Concept
Patrizia Ciofi	Entity
commuter rail	Concept
Sam Crawford	Entity
Rod Laver	Entity
plastic	Concept
bondman	Concept
Toots Hibbert	Entity
panorama	Concept
shopping	Concept
Vorukh	Entity
surf	Concept
oligoastrocytoma	Concept
Olga Lengyel	Entity
maltreatment	Concept
catchment area	Concept
hand drill	Concept
Jane Elliott	Entity
district court	Concept
escheat	Concept
Typhoon Xangsane	Entity
Lyman	Entity
veratrum	Concept
Suzy Favor Hamilton	Entity
immodesty	Concept
Ohio	Entity
ancient philosophy	Concept
sixpence	Concept
Gurf Morlix	Entity
Israel	Entity
warrantor	Concept
still-life	Concept
acre	Concept
unification	Concept
Introducing	Entity
cyclic guanosine monophosphate	Concept
hospital	Concept
Fourth World	Entity
retirement benefit	Concept
Stardock	Entity
orison	Concept
Myrdal	Entity
bulkhead	Concept
smoke	Concept
pusher	Concept
valedictorian	Concept
headshot	Concept
Washington	Entity
executive vice president	Concept
flocculation	Concept
Alec Stewart	Entity
OpenOffice	Entity
telecommunications	Concept
online shopping	Concept
SpamBayes	Entity
reporter	Concept
Rockwell Kent	Entity
dirham	Concept
exponent	Concept
stem-cell research	Concept
visibility	Concept
Oakland City Hall	Entity
conformist	Concept
studbook	Concept
Borregaard	Entity
Turrican	Entity
convert	Concept
inverse distance weighting	Concept
Quantum mechanics	Concept
Cecilia	Entity
crosswind	Concept
Qir	Entity
Pacaya	Entity
Pinball	Entity
Showroom	Concept
Chicago	Entity
navigator	Concept
writing	Concept
Jemison	Entity
Sake	Entity
official	Concept
flipper	Concept
maverick	Concept
Murder One	Entity
Murat Zyazikov	Entity
Allakhazam	Entity
foreshadowing	Concept
Taco Cabana	Entity
tax	Concept
impression	Concept
Sonoma State University	Entity
Michael Nielsen	Entity
innovation	Concept
weekend	Concept
Palazzo Farnese	Entity
Watergate	Entity
Helene Deutsch	Entity
bookkeeping	Concept
ringtone	Concept
camellia	Concept
Three Graces	Entity
preserve	Concept
Bradbury Science Museum	Entity
bowsprit	Concept
PricewaterhouseCoopers	Entity
lobbyist	Concept
capital	Concept
teacher	Concept
residence time	Concept
toll road	Concept
Orange	Entity
cascade	Concept
gatekeeper	Concept
Stanford	Entity
annual report	Concept
status epilepticus	Concept
accolade	Concept
netherworld	Concept
Johnny Ramone	Entity
Juan Cole	Entity
notebook computer	Concept
purplish-red	Concept
customer	Concept
vendue	Concept
paragonite	Concept
committee	Concept
priority	Concept
history of science	Concept
airlock	Concept
brachydactyly	Concept
Battlestar Galactica	Entity
Dungeon Master	Entity
kingbird	Concept
anycast	Concept
neurohypophysis	Concept
Danish Kaneria	Entity
hill	Concept
gift shop	Concept
respiratory disease	Concept
nomination	Concept
cotton candy	Concept
Finding Forrester	Entity
leger	Concept
cistron	Concept
Tulsa	Entity
archeologist	Concept
Middle Ages	Entity
glottal stop	Concept
flavivirus	Concept
John Flamsteed	Entity
Chromosome 9	Entity
hillock	Concept
truth	Concept
gypsum	Concept
ethanol	Concept
report	Concept
deoxyribonucleic acid	Concept
avant-garde	Concept
steppe	Concept
Lake District	Entity
payoff	Concept
Flagship Studios	Entity
drumbeat	Concept
Jesse Alexander	Entity
David Gustafson	Entity
infrastructure	Concept
authoritarian regime	Concept
chuck steak	Concept
edger	Concept
Czestochowa	Entity
net	Concept
Fagopyrum	Concept
monoid	Concept
lyceum	Concept
midfield	Concept
flyswatter	Concept
monoclonal	Concept
green roof	Concept
Lyon	Entity
papillon	Concept
library	Concept
emperor	Concept
FutureGen	Entity
ineptitude	Concept
Valeria Golino	Entity
Supersonics	Entity
light	Concept
RF modulator	Concept
pedestrian	Concept
tau neutrino	Concept
envelopment	Concept
metadata	Concept
Amsterdam Admirals	Entity
Milton Shapp	Entity
Leon Battista Alberti	Entity
Jack Trout	Entity
rotunda	Concept
chief research officer	Concept
Lido	Entity
grant	Concept
nationalization	Concept
outlander	Concept
selector	Concept
standard	Concept
benefaction	Concept
heaven	Concept
senior	Concept
clopidogrel bisulfate	Concept
buckler	Concept
fasces	Concept
actor	Concept
jade	Concept
rematch	Concept
Plovdiv	Entity
jerkin	Concept
retainer	Concept
casserole	Concept
White House	Entity
quads	Concept
pungency	Concept
rue	Concept
acquiescence	Concept
capillary	Concept
Fort Meade	Entity
sub-interval	Concept
sod	Concept
sociology department	Concept
office automation	Concept
paraffin	Concept
Kingdom Hospital	Entity
color constancy	Concept
9mm	Entity
spile	Concept
Fahrenheit	Entity
foreign policy	Concept
saprolite	Concept
lysine	Concept
subject	Concept
ninepence	Concept
maharaja	Concept
warship	Concept
AAC	Entity
Don McKellar	Entity
coast	Concept
Martinair	Entity
bird sanctuary	Concept
cowpox	Concept
southwestward	Concept
Moscow	Entity
Robert Pozen	Entity
Carly Fiorina	Entity
Cherryholmes	Entity
full-duplex	Concept
gasworks	Concept
Harmonia axyridis	Concept
Circle Jerks	Entity
archduke	Concept
tenpence	Concept
rail	Concept
palisade	Concept
flattop	Concept
crossover	Concept
bere	Concept
oil well	Concept
sapote	Concept
biology	Concept
rebel	Concept
suffragette	Concept
Ben Gardner	Entity
Augustine Volcano	Entity
Copernic	Entity
dejection	Concept
railyard	Concept
river	Concept
railroad	Concept
Iran-Iraq War	Entity
sheepshead	Concept
Adobe Flash Lite	Entity
Kristin Luker	Entity
mail	Concept
nag	Concept
Arapaho	Entity
Shoot the Dog	Entity
Darius Painter	Entity
validity	Concept
Gerry Davis	Entity
delta	Concept
John Fitzgerald Kennedy	Entity
spaceport	Concept
impromptu	Concept
sucker	Concept
Surdas	Entity
grenade	Concept
Virtual Console	Entity
John Heydon	Entity
Mayon Volcano	Entity
vibe	Concept
Hurricane Rita	Entity
tower	Concept
Gerrard Winstanley	Entity
hegemony	Concept
corneum	Concept
shoulder	Concept
firm	Concept
parking	Concept
Visual FoxPro	Entity
austral	Concept
closeness	Concept
brush-off	Concept
Lancashire	Entity
journalist	Concept
printing	Concept
Achille	Entity
product	Concept
Itsu	Entity
Reddit	Entity
Marjorie Garber	Entity
webmail	Concept
harvesting	Concept
Malcolm Wallop	Entity
radical feminism	Concept
viola	Concept
strangulation	Concept
Fayette County	Entity
photolithography	Concept
emerald	Concept
restaurant	Concept
shamrock	Concept
episode	Concept
diathermy	Concept
festivity	Concept
masquerade ball	Concept
spotting	Concept
mill	Concept
public service	Concept
florin	Concept
El Nino	Entity
quietness	Concept
aftermath	Concept
potpourri	Concept
spot price	Concept
crooner	Concept
Talcott Parsons	Entity
classification	Concept
compound	Concept
Neon Genesis Evangelion	Entity
Huey Lewis	Entity
outfielder	Concept
James Kirchick	Entity
failure rate	Concept
antenna	Concept
Howard Davis	Entity
nude	Concept
antioxidant	Concept
abnegation	Concept
interpellation	Concept
asterism	Concept
duke	Concept
blueness	Concept
Intersection	Concept
macadam	Concept
learner	Concept
chronic	Concept
seafloor	Concept
Reuel Marc Gerecht	Entity
screen	Concept
raise	Concept
Klaus Nomi	Entity
engram	Concept
referral	Concept
endarteritis	Concept
sigma	Concept
pons	Concept
coma	Concept
Josh Willis	Entity
suzerainty	Concept
stripe	Concept
dhole	Concept
warming	Concept
Urbana University	Entity
filial piety	Concept
Ilex cassine	Concept
debt	Concept
Tom Hanks	Entity
wrestle	Concept
Sergei Shamba	Entity
vaporization	Concept
epistemology	Concept
Indra	Entity
Local Group	Entity
human	Concept
agar	Concept
issuer	Concept
Mister Johnson	Entity
infatuation	Concept
bulk	Concept
brute	Concept
antagonism	Concept
witchgrass	Concept
writer	Concept
Tharsis	Entity
heptose	Concept
flirting	Concept
interdict	Concept
Salang Tunnel	Entity
mentor	Concept
way out	Concept
pula	Concept
Tommy Gavin	Entity
Ari Up	Entity
territory	Concept
minister	Concept
Turtle Mountains	Entity
LRRK2	Entity
grounds	Concept
darkey	Concept
Hurricane Fabian	Entity
stilt	Concept
view	Concept
waxwork	Concept
glutton	Concept
emulator	Concept
Mason & Dixon	Entity
kingdom	Concept
snow	Concept
limousine	Concept
computer industry	Concept
water balloon	Concept
beef	Concept
pe	Concept
Carlos Frenk	Entity
crab	Concept
Wii	Entity
reflex response	Concept
space research	Concept
VersionTracker	Entity
John Passmore	Entity
Wang Xiaolong	Entity
particle	Concept
Timeless	Entity
interior decoration	Concept
expedition	Concept
matchlock	Concept
bunionectomy	Concept
sand verbena	Concept
Jackie Mittoo	Entity
charity	Concept
lemon verbena	Concept
Madia	Concept
MathWorks	Entity
trust company	Concept
Bradgate Park	Entity
allies	Concept
Matthew Flinders	Entity
leveling	Concept
Bronze Horseman	Entity
granadilla	Concept
tussle	Concept
Louisiana	Entity
winner	Concept
ghee	Concept
theme	Concept
mallet	Concept
rep	Concept
ox	Concept
great-grandmother	Concept
doeskin	Concept
white coat	Concept
White Star	Entity
Frederick Sanger	Entity
Martin Brest	Entity
Hurricane Dennis	Entity
Ukraine	Entity
copper	Concept
Universidad	Entity
Ludwig Boltzmann	Entity
BLAST	Entity
department head	Concept
glycogen synthase	Concept
cutoff	Concept
volcanology	Concept
licentiate	Concept
tornado	Concept
City of Whitehorse	Entity
negation	Concept
junk	Concept
Isaiah	Entity
perry	Concept
bridge	Concept
cutlery	Concept
coda	Concept
Susannah York	Entity
ozone	Concept
Ellida	Concept
Prowler	Entity
mould	Concept
reading teacher	Concept
Turkey	Entity
sandbox	Concept
Beowulf	Entity
luffa	Concept
hacker	Concept
guest house	Concept
Evgeny Kissin	Entity
Ken Russell	Entity
Llaima	Entity
meningitis	Concept
striatum	Concept
Bill Douglass	Entity
trade	Concept
streetcar	Concept
covering	Concept
dealer	Concept
St. Edward	Entity
Saadia Gaon	Entity
HDP	Entity
storm	Concept
W. Browning	Entity
quoit	Concept
terawatt	Concept
babysitting	Concept
Secant	Concept
redundancy check	Concept
battle of Plataea	Entity
silhouette	Concept
thiocyanate	Concept
pseudogout	Concept
restitution	Concept
inspection	Concept
medalist	Concept
discharge	Concept
dentist	Concept
Chef Menteur Pass	Entity
Timothy Leary	Entity
Animorphs	Entity
grafting	Concept
phonetic transcription	Concept
Miller	Entity
Jason Harris	Entity
Woolsack	Entity
balsa raft	Concept
collection	Concept
Catscratch	Entity
Pi Sigma Alpha	Entity
grass	Concept
Cyprus	Entity
short-term memory	Concept
stepper	Concept
seignior	Concept
Narragansett Bay	Entity
chaff	Concept
Joe Price	Entity
Tarheel	Concept
Capcom	Entity
doodlebug	Concept
shambles	Concept
wear	Concept
forum	Concept
human rights	Concept
offensive	Concept
lipstick	Concept
stymy	Concept
golden rule	Concept
cap	Concept
chopper	Concept
price of admission	Concept
inch	Concept
melanocyte	Concept
serfdom	Concept
smut	Concept
Jerry Aldridge	Entity
classifier	Concept
domain	Concept
commodity	Concept
gate	Concept
rowlock	Concept
rainfall	Concept
Jane Clifton	Entity
Novi Vinodolski	Entity
rubble	Concept
Cyrus K. Holliday	Entity
Franco Corelli	Entity
IBC	Entity
coupling	Concept
fertility rate	Concept
Kim Il-sung University	Entity
stratum	Concept
Z1	Entity
tahini	Concept
brain	Concept
aldicarb	Concept
nuclear energy	Concept
pragmatics	Concept
sacrifice	Concept
global warming	Concept
diner	Concept
John Franks	Entity
professional designation	Concept
cast	Concept
Save Mart Center	Entity
elimination	Concept
conscience	Concept
residence hall	Concept
communization	Concept
health facility	Concept
ground	Concept
human migration	Concept
mountain	Concept
notion	Concept
tutsan	Concept
photography	Concept
height	Concept
brutalisation	Concept
blunder	Concept
maliciousness	Concept
Poeciliopsis	Concept
riel	Concept
hauling	Concept
sovereign	Concept
snowfall	Concept
biosatellite	Concept
quinine	Concept
affectionateness	Concept
assignment	Concept
law	Concept
sharecropper	Concept
disincentive	Concept
AT&T	Entity
website	Concept
Archaean	Entity
subsidy	Concept
ladino	Concept
avenue	Concept
Eilean Donan	Entity
Bill Pullman	Entity
Katharine Hepburn	Entity
Marisa Tomei	Entity
Simon Upton	Entity
sustainability	Concept
floorshow	Concept
Health Sciences Library	Entity
spell	Concept
Cancun	Entity
The Seven	Entity
subpoena	Concept
Merriam-Webster	Entity
Gitta Sereny	Entity
camlet	Concept
demonstration	Concept
buffer	Concept
Kralendijk	Entity
Robert Boyle	Entity
Winston S. Churchill	Entity
Manage	Entity
John Livingston	Entity
Richard Rathbun	Entity
hockey	Concept
FOTS	Concept
viniculture	Concept
coffee	Concept
sphygmomanometer	Concept
geosphere	Concept
tectonics	Concept
laser	Concept
Mario Kart DS	Entity
specular reflection	Concept
puzzler	Concept
quo warranto	Concept
Roger Fry	Entity
precipitation	Concept
syneresis	Concept
Jeremy Nathans	Entity
Precambrian	Entity
Green	Concept
Soul Train	Entity
osteocyte	Concept
center	Concept
leishmaniasis	Concept
teleportation	Concept
binge	Concept
Dave Littlefield	Entity
Tibet	Entity
thunder	Concept
Morris Carnovsky	Entity
wetsuit	Concept
Ronald Bunting	Entity
wildlife	Concept
hovel	Concept
aileron	Concept
surd	Concept
Younger Dryas	Entity
questionnaire	Concept
guard	Concept
True Life	Entity
Ansel Adams	Entity
emery cloth	Concept
headquarters	Concept
skeet shooting	Concept
proposal	Concept
Ronald Cass	Entity
Delta Theta Phi	Entity
chrysoberyl	Concept
Nancy Milford	Entity
naturalist	Concept
article	Concept
Scott White	Entity
excitement	Concept
curling	Concept
agriculture	Concept
pastry cook	Concept
plate	Concept
oil pollution	Concept
court	Concept
club	Concept
road rage	Concept
Porsche	Entity
slut	Concept
kidney transplantation	Concept
Cumberland Bay	Entity
smoothbore	Concept
hornist	Concept
festival	Concept
form	Concept
star	Concept
L.A. Confidential	Entity
mercer	Concept
