University of Liverpool	Entity
quickening	Concept
West Midlands	Entity
reactionary	Concept
James Sallis	Entity
quake	Concept
small cap	Concept
chaldron	Concept
disk	Concept
Joseph Rodman Drake	Entity
sidestroke	Concept
Derbyshire Peak	Entity
economic growth	Concept
prison	Concept
certified check	Concept
Muhammad Ali Jinnah	Entity
strange quark	Concept
George Soros	Entity
Pope Pius X	Entity
Antony Leung	Entity
Hurricane Claudette	Entity
fund	Concept
Edmund Burke	Entity
Raoul Dufy	Entity
Misti	Entity
Pyrrhus	Entity
Scott Styris	Entity
till	Concept
flavour	Concept
pigweed	Concept
fuse	Concept
pollution	Concept
release notes	Concept
sial	Concept
graphics	Concept
Hurricane Iniki	Entity
Liege	Entity
Chuck Schumer	Entity
bastinado	Concept
Fast Company	Entity
Siliana	Entity
kink	Concept
backwash	Concept
James Renwick	Entity
Cradle Will Rock	Entity
adage	Concept
yawl	Concept
tipper	Concept
kaon	Concept
oviduct	Concept
