Tellico Reservoir	Entity
selector	Concept
innovation	Concept
pons	Concept
lithium	Concept
Rheal Cormier	Entity
regulating	Concept
knickers	Concept
John Munroe	Entity
Catherine Morland	Entity
Otto von Habsburg	Entity
Eteocles	Entity
La Dolce Musto	Entity
Jimmy Tingle	Entity
Belfast Lough	Entity
Jane Elliott	Entity
sarcophagus	Concept
docker	Concept
penetrator	Concept
Umayyad Mosque	Entity
frogmouth	Concept
witch-hunt	Concept
Turrican	Entity
tax	Concept
jockey	Concept
rosiness	Concept
Josh Willis	Entity
workingman	Concept
mallet	Concept
Joan Silber	Entity
Be Yourself	Entity
Meanjin	Entity
workhouse	Concept
baronetcy	Concept
franchise	Concept
glade	Concept
czar	Concept
Emmeline Pankhurst	Entity
Nikon F5	Entity
Grigori Perelman	Entity
curiosa	Concept
Hurricane Dennis	Entity
chopper	Concept
keyboardist	Concept
West Midlands	Entity
department	Concept
triumvirate	Concept
tank	Concept
Siliana	Entity
residence time	Concept
UN	Entity
pragmatics	Concept
unintelligibility	Concept
cell death	Concept
ounce	Concept
sawmill	Concept
Jack Lengyel	Entity
mackerel	Concept
Leon Battista Alberti	Entity
Grosgrain	Concept
Tupelo Press	Entity
admittance	Concept
needlepoint	Concept
transit	Concept
St. Edward	Entity
jet stream	Concept
pud	Concept
valuation	Concept
American Stock Exchange	Entity
psychedelic	Concept
quote	Concept
streptomycin	Concept
colugo	Concept
sun	Entity
back porch	Concept
neurohypophysis	Concept
consigner	Concept
open source	Concept
delay	Concept
gerontocracy	Concept
John Osborne	Entity
chaff	Concept
fault	Concept
Sire Records	Entity
communization	Concept
earphones	Concept
brain	Concept
platform	Concept
inch	Concept
eponychium	Concept
short-term memory	Concept
walk	Concept
hybrid	Concept
happening	Concept
notion	Concept
chip	Concept
Marcel Duchamp	Entity
children	Concept
leopard cat	Concept
Lawrence	Entity
shelter	Concept
record label	Concept
lift	Concept
European Parliament	Entity
Nadezhda von Meck	Entity
German mark	Concept
Dionysius	Entity
kingbird	Concept
panorama	Concept
lousiness	Concept
Qir	Entity
potassium iodide	Concept
Intersection	Concept
relative price	Concept
conformist	Concept
groceries	Concept
Jehuda Reinharz	Entity
gate	Concept
Chromosome 9	Entity
Tacitus	Entity
Caligula	Entity
casino	Concept
Act of Congress	Entity
weekend	Concept
prayer	Concept
Ronald Bunting	Entity
John Barclay	Entity
Ramesh Powar	Entity
lava dome	Concept
stage	Concept
piastre	Concept
Nahum Sonenberg	Entity
H-Net	Entity
civil union	Concept
court	Concept
drumbeat	Concept
termination	Concept
viper	Concept
pasqueflower	Concept
driving	Concept
terrier	Concept
seaquake	Concept
Merriam-Webster	Entity
possession	Concept
attenuator	Concept
militia	Concept
hyperboloid	Concept
snowfall	Concept
executive vice president	Concept
Volkswagen	Entity
library	Concept
metritis	Concept
maple leaf	Concept
Tufts University	Entity
seignior	Concept
Talim	Entity
rowlock	Concept
form	Concept
outfielder	Concept
Earthsea	Entity
debt	Concept
Bill Clinton	Entity
parkway	Concept
family therapy	Concept
spell-checker	Concept
violin	Concept
Cambridge	Entity
Bear Creek	Entity
glutton	Concept
silver	Concept
Konstantin Tsiolkovsky	Entity
Showroom	Concept
foreshadowing	Concept
perpendicular	Concept
perry	Concept
aircraft	Concept
cusp	Concept
Phrygian cap	Concept
Jump Cut	Entity
minke whale	Concept
Lugh	Entity
wind	Concept
Milton Shapp	Entity
writing	Concept
hallelujah	Concept
word	Concept
Robert Adams	Entity
Tang Xianzu	Entity
serial	Concept
shellac	Concept
Amsterdam Admirals	Entity
Samuel Johnson	Entity
Johnny Ramone	Entity
Micronesia	Entity
screen	Concept
Fruitlands	Entity
Richard Kuklinski	Entity
restitution	Concept
green olive	Concept
shortsightedness	Concept
village hall	Concept
Secant	Concept
papillon	Concept
affection	Concept
Surdas	Entity
sunshine	Concept
pusher	Concept
health economics	Concept
barley	Concept
shawl	Concept
recycling	Concept
backstay	Concept
single tax	Concept
sapote	Concept
lysine	Concept
lag	Concept
Now What	Entity
Kovel	Entity
artemisia	Concept
turbofan	Concept
pipe	Concept
edger	Concept
exponent	Concept
mug	Concept
Washburn High School	Entity
Typhoon Xangsane	Entity
time	Concept
Matt Dean	Entity
fresco	Concept
Cocina	Entity
W. Browning	Entity
scrutiny	Concept
Ansel Adams	Entity
horse	Concept
technophobia	Concept
La Veta Pass	Entity
proton pump	Concept
stomach	Concept
font	Concept
airport	Concept
cocoa bean	Concept
flocculation	Concept
price of admission	Concept
beacon	Concept
dentist	Concept
Iceland	Entity
Pusey	Entity
Marienkirche	Entity
debenture	Concept
hound	Concept
poetry	Concept
index	Concept
bunionectomy	Concept
valedictorian	Concept
oriflamme	Concept
business	Concept
Jackie Mittoo	Entity
dirham	Concept
tacking	Concept
winner	Concept
neurologist	Concept
leaf curl	Concept
buckle	Concept
flavin	Concept
Half-Life 2	Entity
playlist	Concept
lunch	Concept
sonogram	Concept
preserve	Concept
space	Concept
Amis	Concept
counterpane	Concept
cobblestone	Concept
Newdale	Entity
balk	Concept
full stop	Concept
Robert Solow	Entity
religionism	Concept
imputation	Concept
agriculture	Concept
sub-interval	Concept
Isle of Arran	Entity
article	Concept
Richard Posner	Entity
maltreatment	Concept
stack	Concept
life history	Concept
Boulder Creek	Entity
arm	Concept
hospital	Concept
Lutyens	Entity
parking	Concept
crisis	Concept
IBC	Entity
lepton	Concept
Plovdiv	Entity
fine	Concept
burgh	Concept
full-duplex	Concept
shamrock	Concept
groundnut	Concept
radio	Concept
pennon	Concept
beneficiary	Concept
catchment area	Concept
transmission	Concept
Tony Trujillo	Entity
endocarditis	Concept
Michael Owen	Entity
Como	Entity
Oakland City Hall	Entity
Kim Il-sung University	Entity
Tasman Glacier	Entity
state of nature	Concept
Modest Mouse	Entity
Circle Jerks	Entity
Robert Boyle	Entity
surf	Concept
pumpkin	Concept
chrysoberyl	Concept
bayan	Concept
Endemic goitre	Concept
pod	Concept
Tommy Gavin	Entity
Miller	Entity
cooking ingredient	Concept
emptiness	Concept
cheat	Concept
Slovenia	Entity
confederacy	Concept
Mohammad Yousuf	Entity
pontiff	Concept
Copernic	Entity
footway	Concept
robber	Concept
Jason Harris	Entity
business software	Concept
Heming	Entity
sedative	Concept
birdwatching	Concept
air mass	Concept
Fort Meade	Entity
demonstration	Concept
declaration	Concept
Young	Entity
Czestochowa	Entity
Quebec	Entity
Pinot blanc	Concept
Nancy	Entity
Pressburg	Entity
jacket	Concept
Kathryn Werdegar	Entity
jingoism	Concept
climate	Concept
turnpike	Concept
killer	Concept
crossover	Concept
terrorism	Concept
asterism	Concept
terawatt	Concept
Dhiren Barot	Entity
reconnoitering	Concept
square sail	Concept
patent	Concept
placebo effect	Concept
skin	Concept
Pindar	Entity
Agrippina	Entity
puzzler	Concept
Winston S. Churchill	Entity
Nsanje	Entity
price reduction	Concept
binge	Concept
risotto	Concept
Korea	Entity
futurist	Concept
ideal gas	Concept
Straight River	Entity
megathrust earthquake	Concept
smallpox virus	Concept
mountain	Concept
Leonardo da Vinci	Entity
interception	Concept
perfidiousness	Concept
emulator	Concept
Maryland	Entity
viniculture	Concept
baba	Concept
bush	Concept
Griselda	Entity
cotton candy	Concept
Pacaya	Entity
Aryabhata	Entity
generation	Concept
lira	Concept
resonance	Concept
Danish Kaneria	Entity
rotunda	Concept
Iran-Iraq War	Entity
inverse distance weighting	Concept
palisade	Concept
granularity	Concept
Laksar	Entity
Shahid Afridi	Entity
judge	Concept
hero	Concept
dulcimer	Concept
make	Concept
duke	Concept
sloop	Concept
district court	Concept
Aksu	Entity
scrolling shooter	Concept
Bealeton	Entity
Matthew Flinders	Entity
Plymouth	Entity
Michelle Thomas	Entity
Robert Trivers	Entity
emergence	Concept
interface	Concept
Skara Brae	Entity
Bharata	Entity
woofer	Concept
True Grit	Entity
malfeasance	Concept
Harold Volkmer	Entity
Campo San Polo	Entity
cistron	Concept
Jack Trout	Entity
Richard Barnes Mason	Entity
vindication	Concept
Funen	Entity
ozone	Concept
James Kirchick	Entity
whoredom	Concept
saltire	Concept
natural resources	Concept
amazon	Concept
Ken Russell	Entity
quietness	Concept
annual report	Concept
Klaus Nomi	Entity
phonics	Concept
sandbox	Concept
Capcom	Entity
wood	Concept
Merovingian	Entity
mercer	Concept
Philip Durell	Entity
lipogram	Concept
Aesculapius	Entity
spare	Concept
homeostasis	Concept
behaviourism	Concept
boundary	Concept
pin money	Concept
designer	Concept
pragmatism	Concept
financial aid	Concept
urus	Concept
dwarf planet	Concept
expedition	Concept
follow-on	Concept
chapter	Concept
candy	Concept
malware	Concept
Willamette University	Entity
hustler	Concept
feudatory	Concept
Union Station	Entity
thermoregulation	Concept
tubing	Concept
shopping	Concept
ghee	Concept
LEGO	Entity
Sachs Harbour	Entity
highschool	Concept
Juan Cole	Entity
sorcerer	Concept
biotechnology	Concept
paragraph	Concept
in-joke	Concept
The Infinite Mind	Entity
housing	Concept
faulting	Concept
Nohar	Entity
kinetic theory	Concept
mode	Concept
sigma	Concept
coalition	Concept
bread	Concept
Isaiah	Entity
linkage	Concept
Cori	Entity
cabin	Concept
aflatoxin	Concept
New Jersey	Entity
Venus	Entity
Canyonlands	Entity
rabble-rouser	Concept
Leon Festinger	Entity
grafting	Concept
smoothbore	Concept
Castlereagh River	Entity
Ryan Hall	Entity
witchery	Concept
warlord	Concept
Andrew McCormick	Entity
bigtooth aspen	Concept
senior status	Concept
D-2	Entity
broiler chicken	Concept
scoutmaster	Concept
Zinc	Entity
product	Concept
discharge	Concept
breechcloth	Concept
Parveen Babi	Entity
expiration date	Concept
Brookline	Entity
John McPherson	Entity
AT&T	Entity
wallop	Concept
St. Augustine	Entity
bastinado	Concept
drug of abuse	Concept
Kingdom	Concept
Aare	Entity
ladino	Concept
advocacy	Concept
Fudan University	Entity
general	Concept
Drawing Restraint 9	Entity
Ieuaf	Entity
staginess	Concept
note	Concept
blame	Concept
Swarthmore	Entity
straight	Concept
philia	Concept
kerchief	Concept
teddy	Concept
Tulsa	Entity
human migration	Concept
Finding Forrester	Entity
Halo Wars	Entity
Qarbon	Entity
vibe	Concept
Ape Escape	Entity
variety	Concept
mask	Concept
BioCryst Pharmaceuticals	Entity
Thanatos	Entity
rubble	Concept
powerhouse	Concept
chest of drawers	Concept
loot	Concept
customer	Concept
State Highway 12	Entity
environment	Concept
sunspot	Concept
zephyr	Concept
granadilla	Concept
fat	Concept
viral marketing	Concept
dejection	Concept
accreditation	Concept
dioxide	Concept
DC	Concept
Susan B. Anthony	Entity
Bronze Horseman	Entity
devotion	Concept
playwriting	Concept
Vorukh	Entity
rectory	Concept
haloalkane	Concept
foreclosure	Concept
Sam Browne	Entity
lemon verbena	Concept
center	Concept
Susan Strasberg	Entity
Wang Xin	Entity
circuit	Concept
computer industry	Concept
Jerry Aldridge	Entity
Hugh Capet	Entity
Feral Interactive	Entity
nomination	Concept
Essex	Entity
decaf	Concept
Gagandeep Singh	Entity
Local Group	Entity
child care	Concept
roaring	Concept
mother	Concept
vision	Concept
Patrizia Ciofi	Entity
Jim Beach	Entity
Fyodor Dostoyevsky	Entity
Breidenbach	Entity
breakwater	Concept
law	Concept
mould	Concept
prexy	Concept
Animorphs	Entity
lappet	Concept
observance	Concept
damages	Concept
skeet shooting	Concept
Culebra	Entity
suite	Concept
Michael Nielsen	Entity
Arapaho	Entity
Belt Line	Entity
Nina Pacari	Entity
guts	Concept
disservice	Concept
sial	Concept
office automation	Concept
Murat Zyazikov	Entity
tortilla	Concept
sanctuary	Concept
acceptance	Concept
McCormick County	Entity
page	Concept
Middle Ages	Entity
anapsid	Concept
spot price	Concept
top side	Concept
supernaturalism	Concept
Aaron Copland	Entity
freedman	Concept
noun	Concept
instrumental	Concept
Serpens Caput	Entity
herb tea	Concept
Red Planet	Entity
slating	Concept
Omiya	Entity
Francisco Pizarro	Entity
enlistment	Concept
arbitrage	Concept
inertia	Concept
Messi	Entity
inspection	Concept
atomizer	Concept
totient	Concept
horsepower	Concept
net	Concept
jackhammer	Concept
relative humidity	Concept
Michigan	Entity
guerilla	Concept
developmental disability	Concept
Dance Mix	Entity
Winsor School	Entity
Cyclone Gafilo	Entity
north	Concept
quarry	Concept
newsprint	Concept
inherited disease	Concept
sphygmomanometer	Concept
light	Concept
Saqqaq	Entity
dunce cap	Concept
Lyman	Entity
ghrelin	Concept
veranda	Concept
distributer	Concept
Taco Cabana	Entity
market value	Concept
studbook	Concept
sliminess	Concept
successor	Concept
WinSCP	Entity
coffee	Concept
conviction	Concept
sparerib	Concept
Andrew Anderson	Entity
groundwater	Concept
dexterity	Concept
Cyprus	Entity
trust	Concept
anticlimax	Concept
Erna Brodber	Entity
Grimm	Entity
road rage	Concept
autoresponder	Concept
lipstick	Concept
palm	Concept
pearl	Concept
Orange	Entity
Giovanni da Verrazzano	Entity
ground level	Concept
Tarleton	Entity
greywacke	Concept
capillary	Concept
accounting	Concept
excommunication	Concept
real world	Concept
horizontal bar	Concept
spring	Concept
Ukraine	Entity
Stardock	Entity
brutalisation	Concept
monzonite	Concept
Greg Germann	Entity
oil pollution	Concept
chips	Concept
Irish	Entity
Slax	Entity
roe	Concept
version	Concept
arms	Concept
Stanford	Entity
cent	Concept
HP	Entity
Kirk Fordice	Entity
quinine	Concept
Cancun	Entity
gabardine	Concept
Fort Klamath	Entity
landgrave	Concept
Cymru	Entity
turnstile	Concept
Keshu	Entity
photograph	Concept
collegian	Concept
Kazak	Concept
Rockwell Kent	Entity
potpourri	Concept
voyager	Concept
delegacy	Concept
Olga Lengyel	Entity
overflow	Concept
chief research officer	Concept
Yapese	Concept
committee	Concept
Huey Lewis	Entity
Mota	Entity
extramarital sex	Concept
spotting	Concept
mycelium	Concept
Date Night	Entity
LRRK2	Entity
tooth	Concept
door	Concept
tornado	Concept
Martha Blount	Entity
Ubu Roi	Entity
sapphire	Concept
curling	Concept
imperialism	Concept
longbow	Concept
mestranol	Concept
mortar	Concept
farmer	Concept
Wii	Entity
Visalia	Entity
stucco	Concept
Pi Sigma Alpha	Entity
referral	Concept
MS	Entity
dhow	Concept
Tharsis	Entity
cricket	Concept
loser	Concept
warfare	Concept
instruction	Concept
pension fund	Concept
Unreal Engine	Entity
oxalic acid	Concept
plumbing	Concept
Turonian	Entity
retrieval	Concept
halfpenny	Concept
terminology	Concept
Frankenstein	Entity
Loon	Entity
Chef Menteur Pass	Entity
Dungeon Master	Entity
degree	Concept
photojournalism	Concept
frame	Concept
samurai	Concept
austral	Concept
customs	Concept
pedagogue	Concept
computational model	Concept
Biebrza National Park	Entity
check-in	Concept
patrician	Concept
tableware	Concept
Robert De Niro	Entity
9mm	Entity
needle	Concept
UDP Lite	Entity
urolith	Concept
Gunther Gebel-Williams	Entity
hakim	Concept
Martin Brest	Entity
ironing	Concept
porphyrin	Concept
liquid	Concept
battle of Leuctra	Entity
joystick	Concept
Louisiana	Entity
eversion	Concept
nonreader	Concept
lunchtime	Concept
summit	Concept
magnetometer	Concept
grit	Concept
Sidney R. Yates	Entity
binder	Concept
Tim Tebow	Entity
appearing	Concept
octopus	Concept
boar	Concept
South Kensington	Entity
policy	Concept
domain	Concept
urinary bladder	Concept
Mixtec	Entity
language	Concept
antagonism	Concept
empire	Concept
Maximum Carnage	Entity
subway	Concept
pinny	Concept
Johan Remkes	Entity
sort	Concept
Lautrec	Entity
lustiness	Concept
Federal Records	Entity
August	Concept
etymologizing	Concept
Ari Up	Entity
Saadia Gaon	Entity
payoff	Concept
invalid	Concept
star	Concept
Jane Asher	Entity
This Love	Entity
Fort Sumter	Entity
extropy	Concept
matchlock	Concept
assistance	Concept
negation	Concept
plasma	Concept
The Race	Entity
wear	Concept
palette	Concept
glen	Concept
Neil Gillman	Entity
Sphagnum	Concept
oat	Concept
exculpation	Concept
paragonite	Concept
bere	Concept
Bill Koski	Entity
promulgation	Concept
tortilla chip	Concept
warship	Concept
actuator	Concept
newsagent	Concept
Fuzion Frenzy 2	Entity
selective mutism	Concept
documentary	Concept
Amoy	Concept
seminar	Concept
Unix shell	Concept
paraffin	Concept
assignment	Concept
quincunx	Concept
gluon	Concept
ten thousand	Concept
escheat	Concept
fire service	Concept
salamander	Concept
police	Concept
Myers-Briggs Type Indicator	Entity
Hero of Alexandria	Entity
pastry cook	Concept
HDP	Entity
fifty	Concept
Sonora	Entity
precognition	Concept
telecommunications	Concept
prince	Concept
grant	Concept
calumniation	Concept
macadam	Concept
van	Concept
striatum	Concept
acquittance	Concept
tropopause	Concept
deregulating	Concept
Charles Alexander	Entity
perdition	Concept
Don McKellar	Entity
Altai Mountains	Entity
seamster	Concept
monoid	Concept
SIMION	Entity
blastomere	Concept
Mason & Dixon	Entity
engram	Concept
copywriter	Concept
violet	Concept
Tectonic	Entity
metropolitan area	Concept
Dublin Bus	Entity
hell	Concept
throw	Concept
Paris	Entity
magnet	Concept
society	Concept
swashbuckler	Concept
ecology	Concept
close combat	Concept
Herman Melville	Entity
gasworks	Concept
phonetic transcription	Concept
General Intelligence Directorate	Entity
Fayette County	Entity
citizen	Concept
Gram Parsons	Entity
Turkey	Entity
strategy	Concept
Mark Tully	Entity
Sam Rainsy	Entity
Karl Friedrich Gauss	Entity
plumbing fixtures	Concept
Kohler	Entity
sapota	Concept
wagoner	Concept
reliability	Concept
Tropical Storm Helene	Entity
Solent	Entity
attorney	Concept
song thrush	Concept
clipping	Concept
personal check	Concept
Niels Bohr	Entity
vigour	Concept
yardage	Concept
wicketkeeper	Concept
palomino	Concept
spectroscope	Concept
conspiracy	Concept
Cumberland Bay	Entity
lordship	Concept
brewing	Concept
soul mate	Concept
Panthera pardus	Concept
write-off	Concept
selection	Concept
Kenai Peninsula	Entity
flip-flops	Concept
flow	Concept
nutrition	Concept
bend	Concept
ulnar artery	Concept
bug	Concept
accessibility	Concept
PlayStation Portable	Entity
wand	Concept
administrator	Concept
complaint	Concept
statice	Concept
collector	Concept
sheepshead	Concept
purplish-red	Concept
flooring	Concept
sodium nitrite	Concept
cingulate gyrus	Concept
sneeze	Concept
John Talbot	Entity
VirtualDubMod	Entity
Julia Child	Entity
stripe	Concept
shipping	Concept
pungency	Concept
Rod Laver	Entity
adobe	Concept
CISC	Concept
Bradbury Science Museum	Entity
advancement	Concept
straw man	Concept
baker	Concept
scallywag	Concept
Tony Malaby	Entity
Wellington Road	Entity
Catoctin Mountain Park	Entity
mouse	Concept
sixpence	Concept
spaceport	Concept
time-ball	Concept
rollercoaster	Concept
coal	Concept
tadpole	Concept
September	Entity
Blisland	Entity
podcast	Concept
Wild Kingdom	Entity
Carlo Levi	Entity
Chris McKenna	Entity
outreach	Concept
Barney Bigard	Entity
Joe Price	Entity
casserole	Concept
Brady Smith	Entity
DirectX	Entity
corpus delicti	Concept
intransitivity	Concept
Gerry Davis	Entity
horseshoer	Concept
St. Bernard Software	Entity
cast	Concept
Fourth World	Entity
babysitting	Concept
gusset	Concept
Fahrenheit	Entity
brittle	Concept
differential	Concept
Antony Leung	Entity
capital	Concept
Dale	Entity
workforce	Concept
Margot Fonteyn	Entity
hometown	Concept
Hadrian	Entity
ecclesiastic	Concept
hardpan	Concept
betaine	Concept
Bevis Hillier	Entity
board	Concept
Flagship Studios	Entity
insignia	Concept
color	Concept
Michael Slote	Entity
Otto Lilienthal	Entity
gelatin	Concept
Iran	Entity
Wolfe	Entity
logotype	Concept
Hurricane Iniki	Entity
flyswatter	Concept
Save Mart Center	Entity
cap	Concept
tower	Concept
shtup	Concept
disposition	Concept
OpenOffice	Entity
assist	Concept
Saint Anna	Entity
light pollution	Concept
Diocletian	Entity
bell-bottoms	Concept
blindfold	Concept
steward	Concept
honesty	Concept
classification	Concept
sister	Concept
disk	Concept
bothy	Concept
patchwork	Concept
continuum	Concept
journalist	Concept
pula	Concept
Beatties	Entity
bear	Concept
WITI	Entity
army	Concept
aerodrome	Concept
University of Liverpool	Entity
Bill Douglass	Entity
hill	Concept
dhole	Concept
Grani	Entity
scabies	Concept
zero	Concept
University of California	Entity
Mount St. Helens	Entity
minors	Concept
Cortes	Entity
Mike Breen	Entity
flak	Concept
special forces	Concept
freethought	Concept
Golden Gate Park	Entity
Susannah Heschel	Entity
Michael Castleman	Entity
staff	Concept
stymy	Concept
nu metal	Concept
roomette	Concept
Don Baldwin	Entity
truth	Concept
height	Concept
Anna Lindh	Entity
syllabication	Concept
Myrdal	Entity
Internet	Concept
benefaction	Concept
standard	Concept
Analytical Engine	Entity
David Ball	Entity
Win Maung	Entity
Verlot	Entity
Old Oaken Bucket	Entity
rhizome	Concept
subsoil	Concept
Carlos Tosca	Entity
George Soros	Entity
kingdom	Concept
pipeline	Concept
mods	Concept
poet	Concept
sculpture	Concept
deposition	Concept
tau neutrino	Concept
Bernina Express	Entity
Indians	Entity
Deck	Concept
drinking	Concept
stake	Concept
Tropical Storm Erika	Entity
compiler	Concept
Brasilia	Entity
alb	Concept
Exodus	Entity
interpellation	Concept
telemovie	Concept
Lancashire	Entity
pseudogout	Concept
Jesse Alexander	Entity
cereal	Concept
far left	Concept
marine	Concept
list	Concept
tapis	Concept
British Home Stores	Entity
share	Concept
Meat Puppets	Entity
digester	Concept
San Andreas	Entity
chauvinism	Concept
road	Concept
Lewis H. Morgan	Entity
Under the Moon	Entity
punishment	Concept
business concern	Concept
Lisa See	Entity
melanocyte	Concept
strangulation	Concept
release	Concept
organdy	Concept
shepherd	Concept
Roy Hattersley	Entity
high commissioner	Concept
Coliseum	Entity
Alec Stewart	Entity
James Nash	Entity
Oklahoma Corporation Commission	Entity
Dustin Hoffman	Entity
smoke	Concept
laburnum	Concept
swamp gum	Concept
Himalaya	Entity
lightning rod	Concept
Mike Allen	Entity
editor in chief	Concept
diabetic nephropathy	Concept
Mexico	Entity
I-20	Entity
incandescence	Concept
marquee	Concept
hyperlink	Concept
Graduate House	Entity
marriage	Concept
sod	Concept
Zimbabwean	Concept
horsehair	Concept
Bislama	Entity
Ernie	Entity
comic	Concept
nationalization	Concept
wingspread	Concept
anticyclone	Concept
miscreant	Concept
adventure	Concept
Scott	Entity
flavivirus	Concept
gamesmanship	Concept
white coat	Concept
wetsuit	Concept
Evgeny Kissin	Entity
secular	Concept
Kingdom Hospital	Entity
decomposition	Concept
Burnaby	Entity
prince consort	Concept
yawl	Concept
storehouse	Concept
editorial	Concept
empennage	Concept
space research	Concept
pet shop	Concept
bye-election	Concept
railroad	Concept
eisteddfod	Concept
conscience	Concept
baptismal font	Concept
leishmaniasis	Concept
investment	Concept
natural gas	Concept
Uraniborg	Entity
Howard Davis	Entity
grapevine	Concept
bottled water	Concept
Tropical Storm Alpha	Entity
farming	Concept
John Flamsteed	Entity
Gerrard Winstanley	Entity
proposal	Concept
AltiVec	Entity
junkware	Concept
weather	Concept
Fredericksburg	Entity
The New Republic	Entity
water balloon	Concept
Roald Amundsen	Entity
Albuquerque	Entity
reporter	Concept
bulkhead	Concept
25th Hour	Entity
trust company	Concept
intramuscular injection	Concept
Vilfredo Pareto	Entity
Nara	Entity
settlement	Concept
switch	Concept
field hospital	Concept
witchgrass	Concept
Frederick Sanger	Entity
Nonesuch Records	Entity
kaon	Concept
golden rule	Concept
complicatedness	Concept
ordinary	Concept
Transantarctic Mountains	Entity
hypostasis	Concept
Republic of Turkey	Entity
festivity	Concept
fertility rate	Concept
service	Concept
subsidy	Concept
potato salad	Concept
dinky	Concept
gdbserver	Concept
hedonism	Concept
Vernon Jarrett	Entity
fleur-de-lis	Concept
Equator	Entity
S4	Concept
priority	Concept
Martin State Airport	Entity
crosswind	Concept
parents	Concept
ensign	Concept
streptomyces	Concept
Wernher von Braun	Entity
monoclonal	Concept
Dunbar	Entity
nuclear war	Concept
liberty	Concept
rue	Concept
Dorothea Puente	Entity
camlet	Concept
poundage	Concept
giro	Concept
delta	Concept
rationing	Concept
augmentation	Concept
True Life	Entity
gegenschein	Concept
jammies	Concept
toll road	Concept
employee	Concept
hooded cloak	Concept
aftermath	Concept
softball	Concept
Chicago	Entity
printing	Concept
John Hodiak	Entity
plantation	Concept
voltage divider	Concept
Flo Ziegfeld	Entity
wrestler	Concept
jeopardy	Concept
torture	Concept
condition	Concept
certificate	Concept
sphinx	Concept
Make the Grade	Entity
White Star	Entity
thunder	Concept
scutcheon	Concept
annals	Concept
leger	Concept
aridity	Concept
Cnidaria	Concept
manufacturing	Concept
rail	Concept
Nancy Milford	Entity
quickening	Concept
calcium	Concept
tempestuousness	Concept
Three Graces	Entity
turn	Concept
commodity	Concept
architecture	Concept
Pure Pinball	Entity
Harold W. Dodds	Entity
Queen Elizabeth	Entity
animation	Concept
notebook computer	Concept
taka	Concept
Standerton	Entity
glottal stop	Concept
curriculum	Concept
Anna Magnani	Entity
flattop	Concept
byroad	Concept
Ceuta	Entity
fish	Concept
market research	Concept
character	Concept
Sonoma State University	Entity
dicoumarol	Concept
Brassica napus	Concept
classifier	Concept
Vera Nazarian	Entity
modeling	Concept
soil pipe	Concept
Gene DeWeese	Entity
shell	Concept
Helen of Troy	Entity
coiner	Concept
boson	Concept
endarteritis	Concept
Renata Kallosh	Entity
belt	Concept
IRA	Concept
Quercus ilex	Concept
sucker	Concept
harvesting	Concept
smut	Concept
Virtual Console	Entity
Narragansett Bay	Entity
consummation	Concept
James Hogg	Entity
Carlos Frenk	Entity
aldicarb	Concept
open-source software development	Concept
City of Whitehorse	Entity
power point	Concept
Ada Comstock	Entity
Ludwig Boltzmann	Entity
trade	Concept
suzerainty	Concept
capsule	Concept
Greek	Entity
episode	Concept
Phi Sigma Pi	Entity
bowsprit	Concept
shoulder	Concept
village	Concept
Turistas	Entity
diameter	Concept
Mario Kart DS	Entity
Susannah York	Entity
Monty Python	Entity
militarization	Concept
timber	Concept
prison	Concept
dirt	Concept
pill	Concept
charcoal	Concept
capability	Concept
column	Concept
plate	Concept
topping	Concept
wheeler	Concept
program	Concept
savoy	Concept
Beijing	Entity
buckler	Concept
Riverboat Discovery	Entity
HandBrake	Entity
diversity	Concept
closeness	Concept
Norfolk	Entity
About.com	Entity
Larry Niven	Entity
World War II	Entity
Dorothy Richardson	Entity
Dave Littlefield	Entity
Transportation	Entity
budget	Concept
validity	Concept
spats	Concept
dike	Concept
green roof	Concept
vaporization	Concept
Typhoon Muifa	Entity
ground	Concept
Susanna Clarke	Entity
logical thinking	Concept
negritude	Concept
freightage	Concept
Knowth	Entity
matador	Concept
rotter	Concept
wage	Concept
lie detector	Concept
alluvium	Concept
guard	Concept
starling	Concept
shed	Concept
inclemency	Concept
republic	Concept
galoshes	Concept
success	Concept
Madia	Concept
carting	Concept
science journalism	Concept
Louisville	Entity
weather forecasting	Concept
L.A. Confidential	Entity
Paul Mellars	Entity
rappel	Concept
enrollee	Concept
multistage rocket	Concept
geode	Concept
antenna	Concept
reaction	Concept
ethanal	Concept
nuclear medicine	Concept
indenture	Concept
storyteller	Concept
Susan Wiggs	Entity
lens	Concept
foster-child	Concept
psychokinesis	Concept
downtime	Concept
United States	Entity
hacker	Concept
hair	Concept
Magnificent Mile	Entity
Universidad	Entity
viceroy	Concept
tectonics	Concept
Angostura Reservoir	Entity
release notes	Concept
warming	Concept
maharaja	Concept
buffer	Concept
louse	Concept
Ivete Sangalo	Entity
diner	Concept
Durham	Entity
tebuconazole	Concept
tundra swan	Concept
fence	Concept
Seekonk	Entity
lava	Concept
cyclicity	Concept
stubble	Concept
Verrier Elwin	Entity
tenpence	Concept
syneresis	Concept
sidestroke	Concept
Edward Weston	Entity
Judd Gregg	Entity
accelerator	Concept
jug	Concept
wire	Concept
Highlander	Entity
global warming	Concept
forum	Concept
Dallas Cowboys Cheerleaders	Entity
Margaret Fuller	Entity
Abutilon theophrasti	Concept
queenfish	Concept
stetson	Concept
Wang Xiaolong	Entity
colonial	Concept
