cittern	Concept
Kiss	Entity
religious music	Concept
Kenny Hickey	Entity
arioso	Concept
chantey	Concept
quickstep	Concept
leitmotiv	Concept
autoharp	Concept
introit	Concept
jaw harp	Concept
washboard	Concept
dance hall	Concept
Gentle Giant	Entity
sonatina	Concept
american alternative	Concept
christian	Concept
Citysong	Entity
fantasies	Concept
Avatar	Entity
misquote	Concept
trombone	Concept
monophony	Concept
a cappella singing	Concept
Richie Havens	Entity
banjo	Concept
obbligato	Concept
sea chantey	Concept
musical accompaniment	Concept
Wagner	Entity
european jazz	Concept
hornpipe	Concept
quadrille	Concept
british invasion	Concept
cantata	Concept
bongo drum	Concept
trios	Concept
classic big band	Concept
jazz	Concept
Photograph	Entity
traditional	Concept
Stream of Consciousness	Entity
epilogue	Concept
Whiskey Tango Ghosts	Entity
Stravinsky	Entity
After the Storm	Entity
gong	Concept
Trapped	Entity
hot jazz	Concept
antiphony	Concept
Supraphon	Entity
Deep Purple	Entity
largo	Concept
postlude	Concept
boogie-woogie	Concept
vallenato	Concept
funk	Concept
melodic theme	Concept
black music	Concept
country music	Concept
Thornography	Entity
contrabassoon	Concept
Renaissance music	Concept
pedal	Concept
art rock	Concept
minuet	Concept
merengue	Concept
scat singing	Concept
schottische	Concept
Up All Night	Entity
pop	Concept
bugle	Concept
The Rolling Stones	Entity
serialism	Concept
divertimento	Concept
chanson	Concept
gospel	Concept
pop music	Concept
celtic folk	Concept
Ira D. Sankey	Entity
Queen	Entity
triangle	Concept
electric guitar	Concept
contemporary folk	Concept
Bounce	Entity
vibraphone	Concept
Hell Is	Entity
nocturnes	Concept
dance	Concept
sextet	Concept
rider	Concept
tenor drum	Concept
singing	Concept
baton	Concept
Ilosaarirock	Entity
tubular bells	Concept
chansons	Concept
Salvation	Entity
suspended cymbal	Concept
idyll	Concept
recitative	Concept
gradual	Concept
classical music	Concept
opera	Concept
arena rock	Concept
musical phrase	Concept
Katy Perry	Entity
musical	Concept
instrumental	Concept
capriccio	Concept
polyphony	Concept
reel	Concept
Eurythmics	Entity
King Crimson	Entity
contralto	Concept
punk revival	Concept
spoken word	Concept
Taiwanese pop	Concept
medley	Concept
soprano saxophone	Concept
krautrock	Concept
Cypress Hill	Entity
chorale	Concept
vihuela	Concept
elegies	Concept
military music	Concept
intermezzo	Concept
passage	Concept
Genesis	Entity
strain	Concept
sousaphone	Concept
partita	Concept
support	Concept
canons	Concept
Yankee Hotel Foxtrot	Entity
industrial	Concept
Only U	Entity
blue-eyed soul	Concept
torch song	Concept
quartette	Concept
Mikey Chung	Entity
Fidelio	Entity
rocksteady	Concept
turntablists	Concept
fiddle	Concept
mandolin	Concept
neo-soul	Concept
Basket Case	Entity
The Clearing	Entity
harmonium	Concept
inversion	Concept
Artwork	Entity
canticle	Concept
Quincy Jones	Entity
rap	Concept
Happily Ever After	Entity
bebop	Concept
Russian pop	Concept
book	Concept
sleigh bells	Concept
lo-fi	Concept
masses	Concept
snare drum	Concept
jazz fusion	Concept
vamp	Concept
four-part harmony	Concept
mallet	Concept
DJ Sharkey	Entity
canon	Concept
Manners	Entity
octet	Concept
Shamrock Diaries	Entity
trio sonata	Concept
vocal	Concept
ska punk	Concept
bongos	Concept
reharmonization	Concept
conga	Concept
ska	Concept
big beat	Concept
macumba	Concept
Brazilian rock	Concept
gramophone	Concept
metalhead	Concept
Indorock	Entity
antiphon	Concept
metal	Concept
rackett	Concept
indie rock	Concept
The Cure	Entity
quote	Concept
bouffe	Concept
Some Kinda Rush	Entity
Kaleidoscope	Entity
harmonization	Concept
Liz Phair	Entity
horn	Concept
hymnody	Concept
harp	Concept
cello	Concept
french pop	Concept
shoegazing	Concept
Frank Sinatra	Entity
rock music	Concept
Stevie Wonder	Entity
Agoraphobia	Entity
blues	Concept
The Clovers	Entity
part	Concept
serious music	Concept
Lollipop	Entity
Roar	Entity
singer-songwriter	Concept
alto saxophone	Concept
potpourri	Concept
post-punk	Concept
counterpoint	Concept
singalong	Concept
brazilian jazz	Concept
kickdrum	Concept
techno	Concept
euro pop	Concept
study	Concept
marching music	Concept
Pavarotti	Entity
Brian Wilson	Entity
soundtrack album	Concept
vocal music	Concept
intro	Concept
cornet	Concept
thumb piano	Concept
Shadows Fall	Entity
Massive Attack	Entity
refrain	Concept
alto flute	Concept
violin	Concept
grand piano	Concept
chamber music	Concept
Good Vibrations	Entity
Latin jazz	Concept
basset horn	Concept
diminution	Concept
Lithuanian rock	Concept
theme	Concept
anticlimax	Concept
French rock	Concept
polyphonic music	Concept
tributes	Concept
Stronger	Entity
love song	Concept
viola	Concept
Fallen	Entity
odes	Concept
Benny Goodman	Entity
Paul McCartney	Entity
epigraph	Concept
drumming	Concept
ballet	Concept
cumbia	Concept
sarabande	Concept
rave	Concept
recital	Concept
rumba	Concept
soft rock	Concept
Apoptygma Berzerk	Entity
Paint It Black	Entity
foreword	Concept
shred	Concept
recorder	Concept
vocal harmony	Concept
bachata	Concept
musical arrangement	Concept
realisation	Concept
wood block	Concept
latin music	Concept
canto	Concept
arias	Concept
AKB48	Entity
rhumba	Concept
cutting	Concept
barcarolle	Concept
tuba	Concept
etudes	Concept
Pakistani rock	Concept
jamaican ska	Concept
Salvatore Adamo	Entity
tambourine	Concept
Metallica	Entity
Russian guitar	Concept
rock guitarists	Concept
musical composition	Concept
fugues	Concept
military march	Concept
house	Concept
serenade	Concept
swing	Concept
Led Zeppelin	Entity
piano	Concept
ocarina	Concept
korean pop	Concept
Baker Street	Entity
vocalizing	Concept
Take Me Out	Entity
guitar gods	Concept
ethnic music	Concept
serial music	Concept
kick drum	Concept
rondo	Concept
Welcome the Night	Entity
keyboardist	Concept
Wrapped Around	Entity
piano sonata	Concept
pastoral	Concept
bassoon	Concept
oboe	Concept
progressive rock	Concept
Mute Print	Entity
trumpet	Concept
incidental music	Concept
vibraphonist	Concept
golden oldie	Concept
Stampede	Entity
signature	Concept
g√ºiro	Concept
piccolo trumpet	Concept
score	Concept
augmentation	Concept
microphone	Concept
quintet	Concept
chorus	Concept
mazurka	Concept
crooning	Concept
baritone guitar	Concept
Heartland rock	Concept
drum kit	Concept
Live Forever	Entity
swedish pop	Concept
adult alternative	Concept
Eminem	Entity
homophony	Concept
doo-wop	Concept
temple blocks	Concept
The Doldrums	Entity
madrigal	Concept
lament	Concept
new jazz	Concept
ranchera	Concept
Iris	Entity
death metal	Concept
andante	Concept
vocal blues	Concept
Deja Entendu	Entity
Iron Maiden	Entity
mezzo-soprano	Concept
Megadeth	Entity
alto clarinet	Concept
post hardcore	Concept
train whistle	Concept
cadenza	Concept
yodeling	Concept
Phil Collins	Entity
seven-string guitar	Concept
Smokey	Entity
Damnation	Entity
urban folk	Concept
bongo drums	Concept
Your Favorite Weapon	Entity
dance music	Concept
operetta	Concept
hard rock	Concept
AC/DC	Entity
fugue	Concept
rock opera	Concept
Beastie Boys	Entity
chimes	Concept
concerto	Concept
claves	Concept
xylophone	Concept
sitar	Concept
short form	Concept
modern blues	Concept
glam	Concept
Peter Gabriel	Entity
The Chariot	Entity
recessional	Concept
flageolet	Concept
Hollywood	Entity
country and western	Concept
cantillation	Concept
american punk	Concept
figured bass	Concept
dulcimer	Concept
soundtrack	Concept
My Bloody Valentine	Entity
drinking song	Concept
twelve-tone music	Concept
Rockfest	Entity
Ascendancy	Entity
Public Enemy	Entity
Silverthorn	Entity
motif	Concept
jump blues	Concept
musical drama	Concept
percussion	Concept
Shakey Ground	Entity
Gittler guitar	Concept
chicago blues	Concept
rap music	Concept
Irma	Entity
italian pop	Concept
musical score	Concept
Someday Came Suddenly	Entity
fantasia	Concept
drum set	Concept
bolero	Concept
songbook	Concept
dixieland	Concept
pastiche	Concept
stride piano	Concept
songstress	Concept
djembe	Concept
scherzo	Concept
modern jazz	Concept
slapstick	Concept
ground	Concept
Angela McCluskey	Entity
polonaise	Concept
arrangement	Concept
clipping	Concept
The Shins	Entity
Neil Young	Entity
Unity Band	Entity
dub	Concept
church music	Concept
Fleetwood Mac	Entity
Space Monkeys	Entity
Donkey	Entity
Art of Life	Entity
crwth	Concept
Handbags and Gladrags	Entity
heavy metal music	Concept
new jack	Concept
texas blues	Concept
karaoke	Concept
ground bass	Concept
bass guitar	Concept
Joy Division	Entity
Like Drawing Blood	Entity
panpipes	Concept
psychedelic rock	Concept
southern rap	Concept
folk song	Concept
Summertime	Entity
progressive	Concept
Dance Revolution	Entity
operettas	Concept
Paul Stookey	Entity
Grappelli	Entity
motive	Concept
southern gospel	Concept
musette	Concept
Back on Track	Entity
organ	Concept
The Beach Boys	Entity
fanfare	Concept
transverse flute	Concept
surf rock	Concept
chamber pop	Concept
gittern	Concept
Steve Mackey	Entity
requiem	Concept
monody	Concept
marimba	Concept
hip-hop	Concept
keyed trumpet	Concept
phrase	Concept
accompaniment	Concept
old-time country	Concept
folk songs	Concept
hymn	Concept
cover song	Concept
britpop	Concept
adult contemporary	Concept
classic country	Concept
sheng	Concept
drums	Concept
Angels Fall First	Entity
ukelele	Concept
Christian rock	Concept
Blur	Entity
air	Concept
motet	Concept
obligato	Concept
southern rock	Concept
Duke Ellington	Entity
dance pop	Concept
transition	Concept
opus	Concept
Elton John	Entity
Spiderwebs	Entity
