heedfulness	Concept
viceroy	Concept
index	Concept
groundwater	Concept
multistage rocket	Concept
guard	Concept
Valjean	Entity
slop	Concept
plasma	Concept
Jerry Oltion	Entity
share	Concept
spelt	Concept
horse	Concept
fils	Concept
PricewaterhouseCoopers	Entity
certificate	Concept
Erna Brodber	Entity
open source	Concept
smuggler	Concept
tectonics	Concept
RVF	Concept
wand	Concept
balsa raft	Concept
Animorphs	Entity
megathrust earthquake	Concept
preparation	Concept
fading	Concept
aileron	Concept
infatuation	Concept
camlet	Concept
switch	Concept
fence	Concept
advancement	Concept
Cortes	Entity
Aesculapius	Entity
cistron	Concept
Burger King	Entity
Adams Express Company	Entity
height	Concept
Anthony Hopkins	Entity
Fayette County	Entity
Young	Entity
smoothbore	Concept
maple leaf	Concept
Hotel Europe	Entity
loot	Concept
Karl Friedrich Gauss	Entity
variety	Concept
landgrave	Concept
mechanics	Concept
streptomycin	Concept
continuum	Concept
Act of Congress	Entity
firm	Concept
suite	Concept
Point Lillias	Entity
Typhoon Lupit	Entity
Flo Ziegfeld	Entity
Joseph Stalin	Entity
dam	Concept
workingman	Concept
snow	Concept
lordship	Concept
Long Tack Sam	Entity
Nyahururu	Entity
Tacitus	Entity
Slovenia	Entity
tipper	Concept
Robert Boyle	Entity
shopping	Concept
John Romer	Entity
larder	Concept
photograph	Concept
watercraft	Concept
bibliographic database	Concept
chaldron	Concept
lift	Concept
satoyama	Concept
monzonite	Concept
mountain	Concept
John Heydon	Entity
trade	Concept
route	Concept
offensive	Concept
carbon dioxide	Concept
synapse	Concept
Andrew McCormick	Entity
Aaron Copland	Entity
Now What	Entity
luffa	Concept
jammies	Concept
cribbage	Concept
Niels Bohr	Entity
railyard	Concept
mill	Concept
offense	Concept
molecule	Concept
puffing	Concept
Grosgrain	Concept
PlayStation Portable	Entity
kidney transplantation	Concept
Nuptse	Entity
follow-on	Concept
caldera	Concept
facilitator	Concept
department	Concept
Plymouth	Entity
wine	Concept
White Star	Entity
Cyrus K. Holliday	Entity
language	Concept
Minnamurra	Entity
viscometry	Concept
forum	Concept
Constantius	Entity
patient	Concept
MetroLink	Entity
notion	Concept
grafting	Concept
coalition	Concept
Bealeton	Entity
Henry Allan	Entity
steeper	Concept
detour	Concept
spell	Concept
waybill	Concept
octillion	Concept
Belfast Lough	Entity
grave	Concept
Lyon	Entity
recission	Concept
degree	Concept
blindfold	Concept
wetsuit	Concept
Jerry Aldridge	Entity
Nadezhda von Meck	Entity
integration	Concept
Straight River	Entity
La Dolce Musto	Entity
dub	Concept
medical emergency	Concept
antagonism	Concept
dhow	Concept
Woolsack	Entity
Union Station	Entity
giantess	Concept
Phoebe Buffay	Entity
retainer	Concept
penis bone	Concept
subsoil	Concept
Bobby Williams	Entity
diabetic nephropathy	Concept
vulcanite	Concept
proprioception	Concept
Iran-Iraq War	Entity
gypsum	Concept
Alex Sink	Entity
Leslie Caron	Entity
organ donor	Concept
snowplow	Concept
edger	Concept
diadem	Concept
great-grandmother	Concept
shtup	Concept
Bell	Entity
deposition	Concept
particle physics	Concept
lost cause	Concept
Monty Python	Entity
Siliana	Entity
Castlereagh River	Entity
secular	Concept
Sake	Entity
lunch	Concept
heritage	Concept
Bill Clinton	Entity
Sandy Mitchell	Entity
Hudson	Entity
Lake District	Entity
Kovel	Entity
pragmatics	Concept
sovereign	Concept
OpenOffice	Entity
cosmic dust	Concept
judgment	Concept
cotton flannel	Concept
convenience	Concept
Reckless Kelly	Entity
impromptu	Concept
engine	Concept
grand	Concept
battle of Leuctra	Entity
Intelligence Bureau	Entity
script	Concept
relative price	Concept
immurement	Concept
sneeze	Concept
Dave Littlefield	Entity
Lachaise	Entity
Amsterdam Admirals	Entity
dwarf planet	Concept
fish	Concept
counterpane	Concept
grenadilla	Concept
Iceland	Entity
attorney	Concept
Itsu	Entity
gabardine	Concept
temperament	Concept
emptiness	Concept
brittle	Concept
Joyce	Entity
abnegation	Concept
activator	Concept
Howard K. Smith	Entity
boatlift	Concept
Jesse Alexander	Entity
Melk	Entity
tortilla chip	Concept
timber	Concept
VirtualDubMod	Entity
avant-garde	Concept
toll road	Concept
Scott	Entity
point	Concept
Knowth	Entity
buckler	Concept
Norfolk	Entity
Franco Corelli	Entity
write-off	Concept
cereal	Concept
Bernina Express	Entity
note	Concept
La Veta Pass	Entity
record label	Concept
Qarbon	Entity
Renata Kallosh	Entity
Deep learning	Concept
rejection	Concept
zero	Concept
north	Concept
Bevis Hillier	Entity
Rudolf Arnheim	Entity
posey	Concept
Culebra	Entity
Carly Fiorina	Entity
complaint	Concept
stack	Concept
peasant	Concept
tapir	Concept
Pinot blanc	Concept
editor	Concept
retribution	Concept
weekend	Concept
washing	Concept
witch-hunt	Concept
star	Concept
cast	Concept
flashlight	Concept
Green	Concept
charlotte	Concept
Robert De Niro	Entity
hosiery	Concept
bloodguilt	Concept
hero	Concept
catsuit	Concept
masquerade ball	Concept
Anna Lindh	Entity
Serpens Caput	Entity
United States	Entity
tricolour	Concept
shelter	Concept
Vietnam	Entity
tapis	Concept
valuation	Concept
chip	Concept
accelerator	Concept
mugwump	Concept
fund	Concept
promulgation	Concept
Vat Phou	Entity
ounce	Concept
Swarthmore	Entity
lepton	Concept
Port Chester	Entity
wrestler	Concept
growth	Concept
restriction fragment	Concept
Solent	Entity
volcanology	Concept
Riptide	Entity
Russell Shorto	Entity
bioenergy	Concept
conditionality	Concept
Beatrice	Entity
scallywag	Concept
Creative	Entity
charcoal	Concept
IronPython	Entity
Prowler	Entity
inverse distance weighting	Concept
magistrate	Concept
Younger Dryas	Entity
riel	Concept
gasworks	Concept
William Jordan	Entity
crab	Concept
Nahum Sonenberg	Entity
Chef Menteur Pass	Entity
hovel	Concept
Indonesia	Entity
science journalism	Concept
Mike Breen	Entity
defeat	Concept
plantation	Concept
glottal stop	Concept
plastic	Concept
Otto Lilienthal	Entity
Aramaic	Entity
oil well	Concept
ground level	Concept
laurel	Concept
soul mate	Concept
full stop	Concept
Sylvette	Entity
carat	Concept
Dionysius	Entity
rue	Concept
Vilfredo Pareto	Entity
plate	Concept
program	Concept
Nina Pacari	Entity
racoon	Concept
baba	Concept
lappet	Concept
religionism	Concept
Cocina	Entity
Rheal Cormier	Entity
Merriam-Webster	Entity
cutlery	Concept
Pusey	Entity
Post	Entity
Cancun	Entity
killer	Concept
docker	Concept
Amsterdam Internet Exchange	Entity
witchery	Concept
Miller	Entity
Pi Sigma Alpha	Entity
phone call	Concept
Tomb Raider	Entity
Bergen	Entity
bridge	Concept
Manarola	Entity
ranch	Concept
transit	Concept
arm	Concept
meningitis	Concept
collection	Concept
word	Concept
student council	Concept
Michigan	Entity
leaf curl	Concept
trailing	Concept
human	Concept
printing	Concept
Busta Rhymes	Entity
jacket	Concept
Nsanje	Entity
smallpox virus	Concept
wage	Concept
Ken Russell	Entity
Jack Lengyel	Entity
miscarriage of justice	Concept
spot price	Concept
exercise	Concept
standard	Concept
escheat	Concept
farmer	Concept
flavivirus	Concept
volcanic rock	Concept
walk	Concept
Leon Festinger	Entity
conspiracy	Concept
Dallas Cowboys Cheerleaders	Entity
West Midlands	Entity
Daniel Bernard Roumain	Entity
Shoot the Dog	Entity
time	Concept
public service	Concept
Richard Starkey	Entity
pastry cook	Concept
Cherryholmes	Entity
Mark Tully	Entity
Murat Zyazikov	Entity
newsagent	Concept
customs	Concept
malware	Concept
Malcolm Wallop	Entity
triple	Concept
emulator	Concept
rotter	Concept
acceptance	Concept
Michael Slote	Entity
Pauli	Entity
Paul Mellars	Entity
terawatt	Concept
bell-bottoms	Concept
benefaction	Concept
strappado	Concept
nonverbal communication	Concept
Chicago	Entity
coiner	Concept
hill	Concept
summerhouse	Concept
Tropical Storm Helene	Entity
Voyager 1	Entity
psychopathology	Concept
Hillbrow	Entity
Ernie	Entity
award	Concept
architecture	Concept
Graduate House	Entity
rail	Concept
executive vice president	Concept
Pyrrhus	Entity
grid	Concept
florin	Concept
Omiya	Entity
generation	Concept
bean	Concept
disincentive	Concept
Dorothy Richardson	Entity
working capital	Concept
South East Wales	Entity
nonsmoker	Concept
serfdom	Concept
chowder	Concept
Josh Willis	Entity
Dhiren Barot	Entity
literature	Concept
ninepence	Concept
Ohio	Entity
Mjolnir	Entity
scabies	Concept
storyteller	Concept
empennage	Concept
bunionectomy	Concept
stationmaster	Concept
South Kensington	Entity
Inland Revenue	Concept
Mokelumne Wilderness	Entity
sugar-cane	Concept
marketing research	Concept
AAC	Entity
Breidenbach	Entity
brutalisation	Concept
Bomberman	Entity
hacksaw	Concept
authentication	Concept
Hamlet	Entity
steward	Concept
parents	Concept
manufacturing	Concept
sonogram	Concept
strategy	Concept
blind	Concept
ordinary	Concept
anticyclone	Concept
torsion	Concept
outlaw	Concept
quake	Concept
Susan Wiggs	Entity
Washington	Entity
sulfur dioxide	Concept
Michelle Thomas	Entity
cap	Concept
Matt Dean	Entity
pula	Concept
Leonhard Euler	Entity
monoclonal	Concept
confederation	Concept
Turrican	Entity
Agrippina	Entity
palette	Concept
El Mercurio	Entity
packet filtering	Concept
Margaret Fuller	Entity
Willow Street	Entity
John Fitzgerald Kennedy	Entity
staginess	Concept
Hugh Capet	Entity
golden rule	Concept
flyswatter	Concept
Tang Xianzu	Entity
regeneration	Concept
backwash	Concept
indisposition	Concept
Laksar	Entity
academician	Concept
Wolfe	Entity
Bernard Laporte	Entity
diploma	Concept
cell death	Concept
dhole	Concept
incandescence	Concept
Ronas Hill	Entity
silver	Concept
Modest Mouse	Entity
spinneret	Concept
placoderm	Concept
advocacy	Concept
The New Republic	Entity
anal sex	Concept
magnet school	Concept
potpourri	Concept
A1 motorway	Entity
lie detector	Concept
Tommy Gavin	Entity
French Broad River	Entity
atomizer	Concept
village	Concept
psychedelic	Concept
shirt	Concept
Tibet	Entity
Battlestar Galactica	Entity
curriculum	Concept
quarry	Concept
frogmouth	Concept
jackhammer	Concept
assist	Concept
City of London	Entity
workhouse	Concept
proton pump	Concept
Funen	Entity
Fudan University	Entity
stetson	Concept
William Cowper	Entity
overflow	Concept
medical care	Concept
Ridge Racer	Entity
straight	Concept
Neumont University	Entity
starling	Concept
grant	Concept
powerhouse	Concept
disciple	Concept
Los Angeles	Entity
human rights	Concept
Soul Train	Entity
threat	Concept
lanugo	Concept
jerkin	Concept
Cecilia	Entity
ringtone	Concept
Pinball	Entity
distribution	Concept
Klaus Nomi	Entity
gatekeeper	Concept
city state	Concept
scutcheon	Concept
East Capitol Street	Entity
windage	Concept
diffusor	Concept
Fahrenheit	Entity
brewing	Concept
Dorion Sagan	Entity
availability	Concept
heptose	Concept
Cumberland Bay	Entity
phonics	Concept
deregulating	Concept
eisteddfod	Concept
studbook	Concept
Wicks	Entity
bondman	Concept
Bowhead whale	Concept
battle of Plataea	Entity
petition	Concept
Maginot	Entity
mackerel	Concept
prairie cordgrass	Concept
makeover	Concept
management	Concept
Mare Island	Entity
Jason Harris	Entity
Marisa Tomei	Entity
Catholic	Concept
Brown	Entity
accounting	Concept
iota	Concept
Edward Weston	Entity
licentiate	Concept
Hurricane Iniki	Entity
horsehair	Concept
John Drew	Entity
Saint Anna	Entity
spare	Concept
newsletter	Concept
Verlot	Entity
service	Concept
riptide	Concept
decal	Concept
City of Whitehorse	Entity
restrictiveness	Concept
confederacy	Concept
sharecropper	Concept
Jackie Mittoo	Entity
Andronicus of Rhodes	Entity
prefix	Concept
crisis	Concept
tutsan	Concept
cyclicity	Concept
empire	Concept
Standerton	Entity
logotype	Concept
policy	Concept
foreign policy	Concept
office automation	Concept
malediction	Concept
rhizome	Concept
chuck steak	Concept
sodium borohydride	Concept
medalist	Concept
referee	Concept
Karl Sax	Entity
ruling	Concept
gerontocracy	Concept
Game Boy Advance	Entity
elimination	Concept
Trimble	Entity
Maxims	Entity
time-ball	Concept
melanocyte	Concept
Half-Life 2	Entity
acquiescence	Concept
software suite	Concept
skin	Concept
Dodie Bellamy	Entity
consultant	Concept
retirement benefit	Concept
softball	Concept
bomber	Concept
sub-interval	Concept
chief research officer	Concept
powertrain	Concept
baronetcy	Concept
placebo effect	Concept
Parveen Babi	Entity
smoke	Concept
copper	Concept
treasure map	Concept
vibe	Concept
voltage divider	Concept
rheumatism	Concept
cookhouse	Concept
Dominique Voynet	Entity
proof	Concept
9mm	Entity
northwester	Concept
Poland	Entity
Tony Malaby	Entity
hardpan	Concept
Richard Rathbun	Entity
shuttle	Concept
lemon verbena	Concept
deserter	Concept
neck	Concept
journal	Concept
tadpole	Concept
Chris Phillips	Entity
nuclear war	Concept
pressing	Concept
Toots Hibbert	Entity
decomposition	Concept
inclemency	Concept
Tom Hanks	Entity
Catherine Morland	Entity
Reddit	Entity
franchise	Concept
pinny	Concept
accolade	Concept
FOTS	Concept
chauvinism	Concept
cascade	Concept
deoxyribonucleic acid	Concept
Before Dark	Entity
world	Concept
MXML	Entity
column	Concept
country	Concept
Battersea Arts Centre	Entity
close combat	Concept
far left	Concept
unintelligibility	Concept
Callender	Entity
portraitist	Concept
Morris Carnovsky	Entity
paragraph	Concept
Fuzion Frenzy 2	Entity
specialist	Concept
accreditation	Concept
aftermath	Concept
stucco	Concept
bird sanctuary	Concept
charity	Concept
escrow	Concept
Quantum mechanics	Concept
differential	Concept
interior decoration	Concept
porphyrin	Concept
payoff	Concept
President Lyndon Johnson	Entity
spectroscope	Concept
James Renwick	Entity
Test Site	Entity
pointer	Concept
Skara Brae	Entity
communization	Concept
pomegranate	Concept
witness	Concept
lipogram	Concept
scrolling shooter	Concept
Ph.D.	Concept
torture	Concept
newsprint	Concept
Antichrist	Entity
estimation	Concept
sod	Concept
Hurricane Claudette	Entity
storehouse	Concept
potato	Concept
Pink Dot	Entity
buffer	Concept
Dirac	Entity
Wellington Road	Entity
pedestrian	Concept
sparerib	Concept
lava dome	Concept
saprolite	Concept
computer industry	Concept
Judd Gregg	Entity
color constancy	Concept
horizontal bar	Concept
mode	Concept
geode	Concept
attic	Concept
tau neutrino	Concept
disk	Concept
anapsid	Concept
Mariamman	Entity
Michael Nielsen	Entity
digester	Concept
weather forecasting	Concept
Z1	Entity
acre	Concept
footway	Concept
rabble-rouser	Concept
waxwork	Concept
Flagship Studios	Entity
flirting	Concept
solid	Concept
WITI	Entity
global warming	Concept
Venus	Entity
beer	Concept
budget	Concept
cloister	Concept
November	Entity
Invermay	Entity
stake	Concept
Lido	Entity
crosswind	Concept
puzzler	Concept
spondee	Concept
sunshine	Concept
Ukraine	Entity
highschool	Concept
retail	Concept
yardage	Concept
commodity	Concept
excommunication	Concept
radio	Concept
Tropical Storm Alpha	Entity
visibility	Concept
Susannah Heschel	Entity
happening	Concept
special forces	Concept
Austin	Entity
Typhoon Xangsane	Entity
Dance Mix	Entity
designation	Concept
ostracism	Concept
Seema Biswas	Entity
round	Concept
lightning rod	Concept
Jimmy Tingle	Entity
Bradgate Park	Entity
ox	Concept
hypostasis	Concept
subtropics	Concept
reaction	Concept
Iran	Entity
HDP	Entity
Gitta Sereny	Entity
Franck Goddio	Entity
San Andreas	Entity
axile placentation	Concept
wood	Concept
longbow	Concept
commander-in-chief	Concept
tebuconazole	Concept
pension	Concept
business software	Concept
commuter rail	Concept
progressive	Concept
oriflamme	Concept
lira	Concept
afterlife	Concept
stratum	Concept
German mark	Concept
prince consort	Concept
res judicata	Concept
Red Planet	Entity
Adam Crosthwaite	Entity
Augustine Volcano	Entity
technophobia	Concept
biotechnology	Concept
wood nymph	Concept
serpent	Concept
Tarleton	Entity
Zhu Di	Entity
cotton candy	Concept
spam	Concept
conscience	Concept
mercer	Concept
committee	Concept
John Hodiak	Entity
sculpture	Concept
Galeras	Entity
militarization	Concept
Sidney R. Yates	Entity
Local Group	Entity
Seanad	Concept
faulting	Concept
boar	Concept
passing	Concept
attenuator	Concept
cheat	Concept
Isle of Arran	Entity
Sajid Mahmood	Entity
Old Oaken Bucket	Entity
source	Concept
subspecies	Concept
balance of power	Concept
Hadronyche	Concept
ancient philosophy	Concept
pilot	Concept
article	Concept
song thrush	Concept
Greg Germann	Entity
lustiness	Concept
resonance	Concept
spats	Concept
Siegfried Sassoon	Entity
Richard Posner	Entity
earl	Concept
Carlos Tosca	Entity
waviness	Concept
enrollee	Concept
Malmo	Entity
Sonora	Entity
syneresis	Concept
tendentiousness	Concept
Mason & Dixon	Entity
gegenschein	Concept
hypertext markup language	Concept
ensign	Concept
greenmail	Concept
maverick	Concept
fox	Concept
form	Concept
State Highway 17	Entity
Aryabhata	Entity
search engine	Concept
territory	Concept
Clean Edge	Entity
dicoumarol	Concept
conglomerate	Concept
St. Vitus	Entity
Michael Castleman	Entity
IRA	Concept
test	Concept
limousine	Concept
price reduction	Concept
20th century	Concept
veratrum	Concept
Finding Forrester	Entity
ozone	Concept
George Lamming	Entity
Paynes Creek	Entity
disengagement	Concept
headmaster	Concept
scouter	Concept
Roald Amundsen	Entity
futurist	Concept
hospital	Concept
burr oak	Concept
insignia	Concept
academic year	Concept
Jenny Oropeza	Entity
rebel	Concept
taxi	Concept
Richard Kuklinski	Entity
Belarus	Entity
self-justification	Concept
imperialism	Concept
hound	Concept
outfit	Concept
eponychium	Concept
Mota	Entity
disservice	Concept
chips	Concept
Touch and Go	Entity
wildlife	Concept
water balloon	Concept
Manassas	Entity
Elbridge Gerry	Entity
coda	Concept
frame	Concept
warship	Concept
tartar	Concept
Wilma Vaught	Entity
Blindsight	Entity
eschaton	Concept
solfege	Concept
Samuel Johnson	Entity
camellia	Concept
check-in	Concept
teleportation	Concept
McCormick County	Entity
Tony Trujillo	Entity
arbitrage	Concept
tussle	Concept
investment	Concept
Chromosome 9	Entity
slating	Concept
pocketbook	Concept
Tim Tebow	Entity
State Highway 12	Entity
paragonite	Concept
Chris McKenna	Entity
tubing	Concept
Wii	Entity
Goonellabah	Entity
Muhammad Ali Jinnah	Entity
Porsche	Entity
loaf	Concept
heaven	Concept
Susannah York	Entity
New Orleans	Entity
petrology	Concept
sorcerer	Concept
stakes	Concept
metadata	Concept
zephyr	Concept
annual general meeting	Concept
Tulsa World	Entity
samurai	Concept
Collin Peterson	Entity
screen	Concept
Fagopyrum	Concept
failure rate	Concept
Ari Up	Entity
flattop	Concept
Pakistan	Entity
interface	Concept
whiteness	Concept
University of Liverpool	Entity
subway	Concept
macroeconomics	Concept
breakfast	Concept
surprise	Concept
Urbana University	Entity
umber	Concept
ergotamine	Concept
Middlesex Guildhall	Entity
Exodus	Entity
viniculture	Concept
emerald	Concept
Amoy	Concept
downlight	Concept
chateau	Concept
library	Concept
Manage	Entity
assertion	Concept
punishment	Concept
NGC 2264	Entity
tax haven	Concept
mail	Concept
cent	Concept
financial aid	Concept
poet	Concept
Chuck Schumer	Entity
personal check	Concept
dike	Concept
Kohler	Entity
Scleranthus	Concept
authoritarian regime	Concept
real estate	Concept
Fast Company	Entity
writing	Concept
Turistas	Entity
behaviourism	Concept
Prionotus	Concept
Watergate	Entity
Blisland	Entity
Biebrza National Park	Entity
madam	Concept
El Nino	Entity
planetary science	Concept
vision	Concept
thiocyanate	Concept
WinSCP	Entity
sucralfate	Concept
John Pankow	Entity
money	Concept
Borregaard	Entity
LRRK2	Entity
pin money	Concept
RELCOM	Entity
wingspread	Concept
clipping	Concept
ewe	Concept
Tufts University	Entity
acanthocephalan	Concept
Ron Donagi	Entity
Griselda	Entity
floorshow	Concept
Copernic	Entity
fess	Concept
Day One	Entity
Mexico	Entity
response	Concept
Gene DeWeese	Entity
John Flamsteed	Entity
Albuquerque	Entity
decentralisation	Concept
representative	Concept
Swami Haridas	Entity
dicky	Concept
demonstration	Concept
sun	Entity
notebook computer	Concept
mischance	Concept
penal colony	Concept
GTA	Entity
Mount St. Helens	Entity
electorate	Concept
Oxford	Entity
Amis	Concept
Murder One	Entity
Visual FoxPro	Entity
reliability	Concept
Robert Key	Entity
milkwort	Concept
summit	Concept
house	Concept
Alternative Tentacles	Entity
handshake	Concept
Hurricane Dennis	Entity
delta	Concept
Simon Upton	Entity
Yapese	Concept
outflow	Concept
Alpha Omega Epsilon	Entity
dentist	Concept
chopper	Concept
Gunther Gebel-Williams	Entity
junkware	Concept
web	Concept
putter	Concept
Xpdf	Entity
wicketkeeper	Concept
Burnaby	Entity
street	Concept
Theodore Roethke	Entity
kingbird	Concept
Essex	Entity
Gondi	Concept
Aare	Entity
recycling	Concept
quietness	Concept
Grimm	Entity
hyperlink	Concept
gannet	Concept
vivisection	Concept
silhouette	Concept
patrician	Concept
chairman	Concept
blackface	Concept
tragedy	Concept
expedition	Concept
monoid	Concept
Dorset	Entity
leishmaniasis	Concept
real world	Concept
documentary	Concept
picture	Concept
MathWorks	Entity
Sam Browne	Entity
Buchenwald	Entity
chromatography	Concept
flavour	Concept
dexterity	Concept
adobe	Concept
Moscow	Entity
argument	Concept
sustainability	Concept
state of nature	Concept
oat	Concept
nitrification	Concept
viral marketing	Concept
ideal gas	Concept
Denning	Entity
Scott White	Entity
Circle Jerks	Entity
inch	Concept
WSRP	Entity
Mitchell Brown	Entity
mould	Concept
Bear Creek	Entity
clopyralid	Concept
warrantor	Concept
Rod Laver	Entity
Michael Costa	Entity
fault	Concept
avenue	Concept
prayer	Concept
full-duplex	Concept
Qir	Entity
Gerrard Winstanley	Entity
Keshu	Entity
tectonic uplift	Concept
manslaughter	Concept
Jane Asher	Entity
cypher	Concept
list	Concept
viper	Concept
certified check	Concept
magnetic dipole	Concept
flak	Concept
farming	Concept
mycelium	Concept
reconnoitering	Concept
Indra	Entity
Quercus ilex	Concept
Dungeon Master	Entity
Jim Beach	Entity
prototype	Concept
épée	Concept
Aksu	Entity
northeaster	Concept
cobblestone	Concept
Rockwell Kent	Entity
hacker	Concept
Helen of Troy	Entity
day	Concept
mestranol	Concept
yawl	Concept
Julia Child	Entity
H-Net	Entity
perry	Concept
ecology	Concept
Maximian	Entity
HMAS Perth	Entity
warfare	Concept
front	Concept
tenement	Concept
court	Concept
granadilla	Concept
logical thinking	Concept
inquisitor	Concept
electron microscopy	Concept
British Home Stores	Entity
piastre	Concept
ladino	Concept
aerodrome	Concept
babysitting	Concept
quoit	Concept
snowfall	Concept
hornist	Concept
invalid	Concept
persecution	Concept
emperor	Concept
view	Concept
salamander	Concept
cusp	Concept
Louisville	Entity
Coinage Act	Entity
Durham	Entity
botany	Concept
Katharine Hepburn	Entity
cricket	Concept
Neil Gillman	Entity
sucker	Concept
metritis	Concept
wallop	Concept
hit	Concept
Hansel	Entity
adult	Concept
Honeyd	Entity
allies	Concept
azathioprine	Concept
syzygy	Concept
Adobe Flash Lite	Entity
relative humidity	Concept
pusher	Concept
Juan Cole	Entity
seminar	Concept
needlepoint	Concept
inheritance	Concept
bush	Concept
bounty hunter	Concept
Slowhand	Entity
Giovanni da Verrazzano	Entity
computational model	Concept
Phrygian cap	Concept
coal	Concept
dioxide	Concept
hair	Concept
royalist	Concept
Nohar	Entity
Crowds and Power	Entity
community	Concept
burning	Concept
stem-cell research	Concept
Lutyens	Entity
O'Connor	Entity
breeze	Concept
festivity	Concept
Simon Walker	Entity
supernaturalism	Concept
Photek	Entity
webmail	Concept
pipe	Concept
breechcloth	Concept
subpoena	Concept
market value	Concept
Dionysia	Concept
overall	Concept
vegetarian	Concept
photography	Concept
tonne	Concept
soil pipe	Concept
preaching	Concept
change-of-pace	Concept
turnpike	Concept
sandbox	Concept
lion	Concept
Nubian	Concept
steppe	Concept
affectionateness	Concept
Oakland City Hall	Entity
festival	Concept
tacking	Concept
complement	Concept
noble	Concept
Tarawa	Entity
diorama	Concept
Kingdom	Concept
balsam	Concept
skeet shooting	Concept
Turtle Mountains	Entity
Nancy Milford	Entity
human migration	Concept
tableware	Concept
Seekonk	Entity
synchronizer	Concept
plume	Concept
valedictorian	Concept
beam	Concept
Fyodor Dostoyevsky	Entity
trade embargo	Concept
Wang Xiaolong	Entity
verbal abuse	Concept
StarCraft	Entity
hockey	Concept
Martinair	Entity
terrorism	Concept
lats	Concept
report	Concept
actor	Concept
Apiaceae	Concept
banyan	Concept
Bill Pullman	Entity
university	Concept
belfry	Concept
Jonathan Freedland	Entity
Uraniborg	Entity
bothy	Concept
galoshes	Concept
mayweed	Concept
margin	Concept
baker	Concept
Howard Davis	Entity
Lars Leksell	Entity
pungency	Concept
optative	Concept
kinetic theory	Concept
Wild Kingdom	Entity
Linum	Concept
pasqueflower	Concept
Macklin	Entity
hometown	Concept
Saadia Gaon	Entity
foreclosure	Concept
Phi Sigma Sigma	Entity
aqueduct	Concept
Valeria Golino	Entity
Bharata	Entity
sodium nitrite	Concept
intransitivity	Concept
Rell Sunn	Entity
ossification	Concept
Josef Gingold	Entity
heller	Concept
Helene Deutsch	Entity
hedonism	Concept
Haven	Entity
Save Mart Center	Entity
doldrums	Concept
Planck	Entity
styrofoam	Concept
The Washington Post	Entity
vigour	Concept
Beatties	Entity
crooner	Concept
shawl	Concept
matchlock	Concept
pafuramidine	Concept
Herman Melville	Entity
preserve	Concept
dinner	Concept
Wernher von Braun	Entity
Windows	Entity
Typhoon Muifa	Entity
cox	Concept
Heming	Entity
colostrum	Concept
camelpox	Concept
sedative	Concept
Mohammad Yousuf	Entity
dunce cap	Concept
Tau Kappa Epsilon	Entity
nuclear power plant	Concept
purplish-red	Concept
oil pollution	Concept
Don Baldwin	Entity
dragnet	Concept
Bradbury Science Museum	Entity
ethanal	Concept
amazon	Concept
jet stream	Concept
nursery rhyme	Concept
shepherd	Concept
Landscape Arch	Entity
haulier	Concept
prexy	Concept
The Race	Entity
Wakashan	Concept
machine	Concept
online shopping	Concept
Eric Becklin	Entity
Republic of Turkey	Entity
beef	Concept
Pure Pinball	Entity
Tobaiwa Mudede	Entity
greensand	Concept
Monash Freeway	Entity
denial-of-service attack	Concept
binder	Concept
bearing	Concept
river	Concept
evolutionary biologist	Concept
CISC	Concept
expiration date	Concept
Ben Gardner	Entity
freight	Concept
autocracy	Concept
Robert Pozen	Entity
commoner	Concept
sport shirt	Concept
vehicle	Concept
fosterling	Concept
tahini	Concept
chrysoberyl	Concept
shipping	Concept
unloading	Concept
telemovie	Concept
power	Concept
Yellowstone Caldera	Entity
philia	Concept
hyperboloid	Concept
pill	Concept
Zelda	Entity
air mass	Concept
wing	Concept
Susanna Clarke	Entity
business	Concept
letter	Concept
priority	Concept
coordinator	Concept
bulkhead	Concept
hustler	Concept
Czestochowa	Entity
workstation	Concept
Hermes	Entity
kid	Concept
BioCryst Pharmaceuticals	Entity
habit	Concept
lemongrass	Concept
Lucrezia Borgia	Entity
dejection	Concept
gift shop	Concept
hauling	Concept
trust	Concept
anycast	Concept
Meat Puppets	Entity
Paul Lafargue	Entity
groceries	Concept
rose	Concept
episode	Concept
Mario Kart DS	Entity
miscreant	Concept
Swing music	Concept
Wang Xin	Entity
loser	Concept
dishwater	Concept
Stan Lee	Entity
agriculture	Concept
This Love	Entity
suspension	Concept
rainfall	Concept
Slax	Entity
Hipparcos	Entity
Olivia de Havilland	Entity
ultranationalism	Concept
sailing ship	Concept
supermajority	Concept
Fort Sumter	Entity
chapter	Concept
Timeless	Entity
gorget	Concept
waiver	Concept
Dennis Lillee	Entity
microprocessor	Concept
Golden Gate Park	Entity
Typhoon Saomai	Entity
quinine	Concept
Hero of Alexandria	Entity
magnetometer	Concept
epistemology	Concept
byroad	Concept
line of duty	Concept
stepper	Concept
knickers	Concept
Azua	Entity
fumigation	Concept
Leon Battista Alberti	Entity
sial	Concept
militia	Concept
tension	Concept
Kenai Peninsula	Entity
wave	Concept
snag	Concept
Salang Tunnel	Entity
Louisiana	Entity
hydrosphere	Concept
prepositional phrase	Concept
signal	Concept
TV	Concept
saltire	Concept
spaceport	Concept
abhorrence	Concept
Halevi	Entity
metre	Concept
Jurmo	Entity
Three Graces	Entity
neurologist	Concept
sphinx	Concept
closeness	Concept
Reconnaissance Battalion	Entity
Canyonlands	Entity
inherited disease	Concept
Danish Kaneria	Entity
Anthony Caro	Entity
turn	Concept
S4	Concept
John Edward Taylor	Entity
