meat	cow	cattle	bovine	animal
fragment
lecturer	academician	person	faculty member	professor	educator	american literature	reader	assistant professor	academic	educationist	faculty	prof	instructor	teacher
political organization	form of government	monarchy	polity	political system	regime	social control	corporation	political organisation	enterprise	religious ritual
molecular entity	chemical group
fictional character	fictitious character	imaginary being	person	imaginary creature	cartoon character
city
means of transportation	medium	transportation	transmission	travel	move	passenger transport	mechanism	motion	means of transport	mechanical assembly	traveling	mode of transport	travelling	transport
manga	serial	television series	tv program	series	television program	tv show	television show	tv series	anime
action game	electronic game	video game	software program	software package	software	application	application software	computer program	software application
star	actress	celebrity	entertainer	person
illness	sickness	autoimmune disease	arthritis	disease	inflammatory disease	disorder
disagreeable person	person	unpleasant person
catholic	christian	clergyman	diocese	bishopric	person	priest	holy order	religious person	priesthood
horticulture	culture	cultivation	task
interpretation	explanation	account	written communication	display case
map	american state	mapping	state	ship	u.s. state	boat
coat
person	worker
fish anatomy	biological group	marine ecology	bony fish	seafood	sea creature	terminologist	animal	fish	marine creature	saltwater fish
map
chain
oxen	cow	wild ox	hoofed mammal	bovid	ox	cows	mammal
person	chemist
talk
weapon	mechanism	projectile
visual arts	picture	image	visual art	painting	painter
pc game	app	application program	computer program	videogaming	computer programme	spy satellite	computer game	application	software package	person	applications software	video game	computer software
protocol	software program	console	software
band	musical group	music group	rock group	rock band
body process
chef	person	cook	head cook	head chef
person	eater	consumer	user
designated place	installation art
thespian	electronic media	series	television show	actor	film	work of art	tv program	television series	cinematography	miniseries	movie	television program	recording	person	tv show	mythical being	tv series	visual art	motion picture
island	isle
infrastructure	main road
story	task	television series	film	binary relation	novel	whodunit	wit	detective story	mass medium	funnies	detective
applause	oscillation	musical work	time interval	reinforcement	mechanical assembly	projectile	contestant	devising	movement	golf game
exploration	adventurer	explorer
emotionality	emotionalism	affect
sensation	perception	taste	experience	state	atmosphere	definite quantity
island	isle
architectural element	barrier	entryway	entrance	passage	obstruction	entry	entranceway
astrophysicist	person
person	writer	literate	intellectual
stone	rock
parcel of land	measure
rate	ratio
town
