obligato	Concept
fantasia	Concept
score	Concept
Fairport Convention	Entity
gregorian chant	Concept
French rock	Concept
neotraditional	Concept
glam	Concept
Yes	Entity
minuets	Concept
serenade	Concept
Angels Fall First	Entity
percussion	Concept
ragtime	Concept
metal	Concept
voice part	Concept
solmization	Concept
krautrock	Concept
seven-string guitar	Concept
preface	Concept
section	Concept
dub	Concept
world dance	Concept
Mike Hickey	Entity
jazz	Concept
Paint It Black	Entity
adult alternative	Concept
dance music	Concept
Tom Waits	Entity
polyphony	Concept
Thornography	Entity
punk	Concept
operetta	Concept
Mayhem	Entity
Whiskey Tango Ghosts	Entity
piano music	Concept
contrabassoon	Concept
Dream Theater	Entity
folk rock	Concept
modern jazz	Concept
soundtrack album	Concept
suite	Concept
glam rock	Concept
salutation	Concept
lead sheet	Concept
Jimi Hendrix	Entity
Apoptygma Berzerk	Entity
triangle	Concept
contemporary folk	Concept
torch song	Concept
Taiwanese pop	Concept
karaoke	Concept
Lithuanian rock	Concept
Alison Goldfrapp	Entity
Megadeth	Entity
Queen	Entity
classic country	Concept
Citysong	Entity
opus	Concept
melodic line	Concept
quartet	Concept
gavotte	Concept
sousaphone	Concept
bass guitar	Concept
Spiderwebs	Entity
electric guitar	Concept
discant	Concept
Neil Young	Entity
All Wrapped Up	Entity
swedish pop	Concept
opera	Concept
rondo	Concept
Nevermind	Entity
Third Stage	Entity
chorale prelude	Concept
The Ventures	Entity
spoken word	Concept
steel drums	Concept
counterpoint	Concept
crash cymbals	Concept
antiphonal	Concept
timpani	Concept
vocal music	Concept
waltz	Concept
chantey	Concept
Blur	Entity
The Reeling	Entity
psalm	Concept
emo	Concept
The Arrival	Entity
merengue	Concept
passion	Concept
Kazimierz Serocki	Entity
Krush	Entity
baritone saxophone	Concept
art rock	Concept
barcarolle	Concept
samba	Concept
signature tune	Concept
Robert Cray	Entity
work song	Concept
post hardcore	Concept
Peter Gabriel	Entity
chorus	Concept
love song	Concept
Fleetwood Mac	Entity
neo-soul	Concept
maracas	Concept
Photograph	Entity
golden oldie	Concept
smooth jazz	Concept
Sister Ray	Entity
progressive	Concept
riff	Concept
Grapevyne	Entity
The Chariot	Entity
Salad Days	Entity
Pink Floyd	Entity
ranchera	Concept
theme song	Concept
bass clarinet	Concept
british invasion	Concept
Loaded	Entity
sarabande	Concept
glissando	Concept
overture	Concept
flourish	Concept
Quincy Jones	Entity
surf rock	Concept
primo	Concept
Group Therapy	Entity
Louis Armstrong	Entity
Artwork	Entity
Nine Inch Nails	Entity
comedic music	Concept
epigraph	Concept
musical saw	Concept
skiffle	Concept
3 Words	Entity
country and western	Concept
hard rock	Concept
Hell Is	Entity
southern rock	Concept
instrumental	Concept
grand piano	Concept
swing jazz	Concept
The Beatles	Entity
My My	Entity
pastoral	Concept
stride piano	Concept
claves	Concept
rave	Concept
musical	Concept
celtic folk	Concept
concerto	Concept
misquote	Concept
freestyle	Concept
Planet Earth	Entity
garage punk	Concept
Elvis Presley	Entity
gittern	Concept
The Clash	Entity
X Japan	Entity
Russian guitar	Concept
Hollywood	Entity
singing	Concept
King Crimson	Entity
mazurkas	Concept
rock music	Concept
Supernatural	Entity
idyll	Concept
bass	Concept
trombone	Concept
Nightwish	Entity
tarantella	Concept
cittern	Concept
straight edge	Concept
Irma	Entity
bell lyre	Concept
Salvatore Adamo	Entity
Stereolab	Entity
Iris	Entity
character piece	Concept
a cappella singing	Concept
recapitulation	Concept
waltzes	Concept
Depeche Mode	Entity
signature	Concept
macumba	Concept
introit	Concept
harmonization	Concept
Shakey Ground	Entity
The Offspring	Entity
epilogue	Concept
paean	Concept
bouffe	Concept
transverse flute	Concept
disco	Concept
homophony	Concept
John Peel	Entity
Nirvana	Entity
aria	Concept
pop	Concept
scat	Concept
mouth organ	Concept
urban folk	Concept
chorale	Concept
Duke Ellington	Entity
bongo drum	Concept
Angela McCluskey	Entity
religious music	Concept
Mikey Chung	Entity
vocal	Concept
metalhead	Concept
Shamrock Diaries	Entity
Joe Satriani	Entity
Whip My Hair	Entity
chamber music	Concept
Duran Duran	Entity
finger cymbals	Concept
incidental music	Concept
slapstick	Concept
instrumental music	Concept
intermezzo	Concept
punk revival	Concept
tin whistle	Concept
tom-tom	Concept
march	Concept
Björk	Entity
alternative rock	Concept
antiphonary	Concept
quartette	Concept
boogie	Concept
classical	Concept
anthem	Concept
rackett	Concept
southern soul	Concept
electric blues	Concept
bagatelle	Concept
ukelele	Concept
pedal	Concept
variation	Concept
Ilosaarirock	Entity
Fireworks	Entity
euphonium	Concept
serialism	Concept
guitar	Concept
The Cure	Entity
Frank Sinatra	Entity
traditional	Concept
teen pop	Concept
baton	Concept
Art of Life	Entity
musical theme	Concept
fantasies	Concept
AKB48	Entity
musical harmony	Concept
Stronger	Entity
DJ Sharkey	Entity
Avalon	Entity
jump blues	Concept
vocalizing	Concept
rock	Concept
progressive metal	Concept
musical bow	Concept
southern gospel	Concept
recessional	Concept
Deep Purple	Entity
intro	Concept
boogie-woogie	Concept
humming	Concept
songbook	Concept
obbligato	Concept
saxophone	Concept
bachata	Concept
canons	Concept
Lollipop	Entity
Motörhead	Entity
postlude	Concept
Hockey	Entity
trip-hop	Concept
arioso	Concept
diminution	Concept
sheet music	Concept
Wagner	Entity
christmas carol	Concept
Chamberlin	Entity
orchestra bells	Concept
west coast	Concept
capriccio	Concept
jangle pop	Concept
anticlimax	Concept
euphony	Concept
Brian Wilson	Entity
backup	Concept
lied	Concept
Telegraph Road	Entity
bugle	Concept
Black Sabbath	Entity
The Doldrums	Entity
leitmotif	Concept
David Bisbal	Entity
cymbal	Concept
partita	Concept
bass saxophone	Concept
reel	Concept
Brazilian rock	Concept
quadrille	Concept
progressive rock	Concept
Pavarotti	Entity
nocturne	Concept
techno	Concept
dixieland	Concept
vallenato	Concept
soundtrack	Concept
ambient	Concept
harmonisation	Concept
contrabass clarinet	Concept
trumpet	Concept
easy listening	Concept
trad	Concept
vocal jazz	Concept
concertos	Concept
psychedelic rock	Concept
arias	Concept
Trapped	Entity
Dark Passion Play	Entity
güiro	Concept
orchestration	Concept
Joy Division	Entity
duette	Concept
thumb piano	Concept
AC/DC	Entity
adagio	Concept
piano sonata	Concept
voices	Concept
motet	Concept
sonata	Concept
big beat	Concept
Bob Dylan	Entity
hornpipe	Concept
Bedrock Records	Entity
musical arrangement	Concept
Zeraphine	Entity
djembe	Concept
Kenny Hickey	Entity
Peace of Mind	Entity
Supraphon	Entity
tubular bells	Concept
psalmody	Concept
pastiche	Concept
latin music	Concept
drums	Concept
monody	Concept
allegro	Concept
Russian pop	Concept
improvisation	Concept
Heart Food	Entity
fiddle	Concept
carioca	Concept
zydeco	Concept
latin rock	Concept
The Ultimate	Entity
viola	Concept
flamenco	Concept
flageolet	Concept
mallet	Concept
theme	Concept
ballad	Concept
industrial	Concept
trios	Concept
dance pop	Concept
cantillation	Concept
chant	Concept
harp	Concept
Salvation	Entity
Fidelio	Entity
keyed trumpet	Concept
clarinet	Concept
organ	Concept
post-punk	Concept
melody	Concept
harmonium	Concept
surf guitar	Concept
ska	Concept
Carl Davis	Entity
Gittler guitar	Concept
adult contemporary	Concept
jive	Concept
classic rock	Concept
four-part harmony	Concept
delta blues	Concept
The Clearing	Entity
The Beach Boys	Entity
toccata	Concept
Shadows Fall	Entity
serial music	Concept
drum kit	Concept
ground	Concept
Madonna	Entity
Manners	Entity
odes	Concept
shoegazing	Concept
ballroom music	Concept
program music	Concept
Origin	Entity
Unity Band	Entity
tango	Concept
rock and roll	Concept
Heartland rock	Concept
british punk	Concept
melodic theme	Concept
cowboy	Concept
tenor	Concept
Mackey Feary	Entity
study	Concept
new age	Concept
bongo drums	Concept
rock opera	Concept
finale	Concept
funk	Concept
pastorale	Concept
blue-eyed soul	Concept
preamble	Concept
quotation	Concept
masses	Concept
Stevie Wonder	Entity
polonaise	Concept
Donkey	Entity
indie rock	Concept
conductor	Concept
Wu-Tang Clan	Entity
lyricism	Concept
songstress	Concept
outlaw country	Concept
country music	Concept
piece of music	Concept
musical drama	Concept
korean pop	Concept
folk	Concept
serious music	Concept
math rock	Concept
Boy George	Entity
Back on Track	Entity
power pop	Concept
grand opera	Concept
Eurythmics	Entity
tuba	Concept
oratorio	Concept
Cypress Hill	Entity
Elvis Costello	Entity
air	Concept
quickstep	Concept
pibroch	Concept
musette	Concept
light opera	Concept
chimes	Concept
goth	Concept
harmony	Concept
marching music	Concept
carol	Concept
Latin jazz	Concept
canticle	Concept
minuet	Concept
lullabies	Concept
glockenspiel	Concept
Mute Print	Entity
soprano saxophone	Concept
sextet	Concept
harmonica blues	Concept
orchestral jazz	Concept
arrangement	Concept
The Shins	Entity
Rancid	Entity
Massive Attack	Entity
folk song	Concept
traditional pop	Concept
chicago blues	Concept
oboe	Concept
jamaican ska	Concept
Grappelli	Entity
swing music	Concept
Lollipops and Roses	Entity
Electric guitar	Concept
cacophony	Concept
bebop	Concept
Summertime	Entity
My Chemical Romance	Entity
bop	Concept
Tony Brock	Entity
britpop	Concept
drumstick	Concept
lyre	Concept
folk ballad	Concept
pop music	Concept
shred	Concept
tenor saxophone	Concept
etude	Concept
Jim O'Rourke	Entity
Sky Blue Sky	Entity
