jaw harp	Concept
homophony	Concept
The Whole Shebang	Entity
irish folk	Concept
Brian Eno	Entity
finger cymbals	Concept
My My	Entity
dixieland	Concept
cutting	Concept
metalhead	Concept
Hot Issue	Entity
melody	Concept
Loaded	Entity
The Donkeys	Entity
extract	Concept
steel drums	Concept
Lollipop	Entity
regional blues	Concept
James Brown	Entity
harmonium	Concept
modern jazz	Concept
Russian pop	Concept
Johnny Cash	Entity
alto saxophone	Concept
Lose My Breath	Entity
Indorock	Entity
power pop	Concept
vihuela	Concept
mazurkas	Concept
church music	Concept
quintet	Concept
Good Vibrations	Entity
bass	Concept
mazurka	Concept
musical harmony	Concept
cadenza	Concept
chansons	Concept
progressive rock	Concept
Hockey	Entity
air	Concept
Planet Earth	Entity
recital	Concept
intonation	Concept
instrumental music	Concept
clarinet	Concept
ballads	Concept
quotation	Concept
Mikey Chung	Entity
jazz	Concept
preparation	Concept
salutation	Concept
industrial	Concept
teen pop	Concept
Avalon	Entity
religious music	Concept
shoegazing	Concept
Avatar	Entity
Beastie Boys	Entity
musical bow	Concept
rock opera	Concept
crash cymbals	Concept
flageolet	Concept
King Crimson	Entity
gospel	Concept
singing	Concept
Christian rock	Concept
My Chemical Romance	Entity
canticle	Concept
dubstep	Concept
antiphonal	Concept
The Beyond	Entity
goth	Concept
coda	Concept
musical score	Concept
Paul McCartney	Entity
yodeling	Concept
habanera	Concept
lullaby	Concept
Ãœber	Entity
drumming	Concept
bolero	Concept
post-punk	Concept
ska punk	Concept
musette	Concept
toccata	Concept
Duke Ellington	Entity
track	Concept
european jazz	Concept
Fidelio	Entity
new wave	Concept
Sonic Youth	Entity
sea chantey	Concept
suite	Concept
rhumba	Concept
modern blues	Concept
Black Sabbath	Entity
sheng	Concept
Quincy Jones	Entity
tin whistle	Concept
tuba	Concept
Nightshift	Entity
musical saw	Concept
vocal pop	Concept
ska	Concept
Mute Print	Entity
polyphonic music	Concept
excerpt	Concept
boogie-woogie	Concept
rock guitarists	Concept
southern gospel	Concept
tone poem	Concept
madrigal	Concept
piano music	Concept
military march	Concept
Goldfrapp	Entity
Queen	Entity
death metal	Concept
Brazilian rock	Concept
punk	Concept
train whistle	Concept
wood block	Concept
four-part harmony	Concept
pastorale	Concept
vibraphonist	Concept
orchestra bells	Concept
violoncello	Concept
celtic folk	Concept
Dance Revolution	Entity
dulcimer	Concept
harmonica blues	Concept
Louis Armstrong	Entity
mezzo-soprano	Concept
Aphex Twin	Entity
schottische	Concept
new jack	Concept
baroque pop	Concept
serialism	Concept
Deep Purple	Entity
transverse flute	Concept
duo	Concept
movie soundtrack	Concept
Russian guitar	Concept
Latin hip-hop	Concept
Happily Ever After	Entity
west coast blues	Concept
claves	Concept
vocal	Concept
organ	Concept
voice part	Concept
lyricism	Concept
Bedrock Records	Entity
Katy Perry	Entity
Summertime	Entity
mbira	Concept
tenor tuba	Concept
comedic music	Concept
rebec	Concept
kick drum	Concept
programme music	Concept
double bass	Concept
gigue	Concept
ground bass	Concept
Renaissance music	Concept
Gittler guitar	Concept
industrial dance	Concept
monochord	Concept
opus	Concept
David Bisbal	Entity
signature tune	Concept
leitmotiv	Concept
realisation	Concept
Radiohead	Entity
tenor saxophone	Concept
solo	Concept
chorus	Concept
refrain	Concept
gregorian chant	Concept
The Beatles	Entity
bassoon	Concept
samba	Concept
epigraph	Concept
Shakey Ground	Entity
Seraphim	Entity
scherzo	Concept
intermezzo	Concept
Trapped	Entity
etudes	Concept
american punk	Concept
odes	Concept
Shadows Fall	Entity
morceau	Concept
threnody	Concept
latin music	Concept
funk	Concept
leitmotif	Concept
bass saxophone	Concept
latin rock	Concept
Some Kinda Rush	Entity
Grateful Dead	Entity
Basket Case	Entity
impromptu	Concept
Prince	Entity
rock'n'roll	Concept
Sister Ray	Entity
Electric guitar	Concept
U2	Entity
mandolin	Concept
sheet music	Concept
experimental rap	Concept
grand opera	Concept
hymnody	Concept
contrabassoon	Concept
Ascendancy	Entity
macumba	Concept
The Clearing	Entity
diminution	Concept
vamp	Concept
bugle	Concept
adult contemporary	Concept
Jimi Hendrix	Entity
ostinato	Concept
Frank Zappa	Entity
classic rock	Concept
timpani	Concept
cabaret	Concept
intro	Concept
glissando	Concept
tributes	Concept
Stereolab	Entity
bop	Concept
Cypress Hill	Entity
Kaleidoscope	Entity
southern rap	Concept
concert grand piano	Concept
Edwin Birdsong	Entity
choir	Concept
waltz	Concept
Nas	Entity
Antichrist Superstar	Entity
Silverthorn	Entity
Nevermind	Entity
3 Words	Entity
soprano saxophone	Concept
skiffle	Concept
sonatina	Concept
swing	Concept
divertimento	Concept
piano	Concept
Boy George	Entity
doo wop	Concept
dance hall	Concept
polyphony	Concept
bell lyre	Concept
Wu-Tang Clan	Entity
Lollipops and Roses	Entity
support	Concept
Naked	Entity
AKB48	Entity
Handbags and Gladrags	Entity
soundtrack	Concept
Baker Street	Entity
For Sleepyheads Only	Entity
Someday Came Suddenly	Entity
world dance	Concept
pastoral	Concept
ocarina	Concept
chanting	Concept
Grapevyne	Entity
antiphony	Concept
country rock	Concept
symphony	Concept
drum cadence	Concept
religious song	Concept
medley	Concept
viola	Concept
bel canto	Concept
Supernatural	Entity
rock and roll	Concept
The Crusade	Entity
coloratura	Concept
concertos	Concept
lieder	Concept
rackett	Concept
musical theme	Concept
oratorio	Concept
tin pan alley	Concept
Citysong	Entity
washboard	Concept
folk	Concept
Gentle Giant	Entity
traditional	Concept
The Velvet Underground	Entity
grate	Concept
nocturne	Concept
Annie Lennox	Entity
dithyramb	Concept
Taiwanese pop	Concept
post hardcore	Concept
Telegraph Road	Entity
Depeche Mode	Entity
Shamrock Diaries	Entity
love-song	Concept
barcarolle	Concept
trio sonata	Concept
The Shins	Entity
bluegrass	Concept
garage punk	Concept
Ramones	Entity
shock rock	Concept
ragtime	Concept
alternative rock	Concept
musical composition	Concept
easy listening	Concept
oboe	Concept
sousaphone	Concept
Genesis	Entity
Stampede	Entity
quartette	Concept
The Doldrums	Entity
a cappella singing	Concept
After the Storm	Entity
baritone horn	Concept
ambient pop	Concept
temple blocks	Concept
psytrance	Concept
passion	Concept
humming	Concept
finale	Concept
largo	Concept
continuo	Concept
latin pop	Concept
Rolling Stones	Entity
punk rock	Concept
tenor drum	Concept
ambient	Concept
arias	Concept
arrangement	Concept
Elvis Costello	Entity
The Offspring	Entity
bongo drums	Concept
clavichord	Concept
tarantella	Concept
drum & bass	Concept
hard rock	Concept
Backstreet Boys	Entity
vocal harmony	Concept
Your Favorite Weapon	Entity
incidental music	Concept
contralto	Concept
piece of music	Concept
Back on Track	Entity
traditional folk	Concept
electronica	Concept
overture	Concept
trad	Concept
karaoke	Concept
opera	Concept
Joy Division	Entity
Rockfest	Entity
rock	Concept
flamenco	Concept
masses	Concept
fantasia	Concept
Bob Dylan	Entity
Metallica	Entity
recorder	Concept
requiem	Concept
heavy metal music	Concept
flute	Concept
Photograph	Entity
adagio	Concept
capriccio	Concept
pavan	Concept
ranchera	Concept
sonata	Concept
Welcome the Night	Entity
Kiss	Entity
piano blues	Concept
acid rock	Concept
fantasies	Concept
musical passage	Concept
Smokey	Entity
cover song	Concept
Fairport Convention	Entity
harp	Concept
Pennywise	Entity
adult alternative	Concept
Hawkwind	Entity
maracas	Concept
sitar	Concept
classical	Concept
minuet	Concept
drum kit	Concept
march	Concept
arioso	Concept
quintette	Concept
canons	Concept
pop music	Concept
trip-hop	Concept
Thornography	Entity
riot grrl	Concept
christmas carol	Concept
southern soul	Concept
cowboy	Concept
Manners	Entity
swing music	Concept
xylophone	Concept
Carl Davis	Entity
The Prodigy	Entity
hornpipe	Concept
prologue	Concept
scottish folk	Concept
symphonic music	Concept
castanets	Concept
The Rolling Stones	Entity
Richie Havens	Entity
celesta	Concept
alternative metal	Concept
Sky Blue Sky	Entity
hot jazz	Concept
french pop	Concept
Frank Sinatra	Entity
Krush	Entity
Kenny Hickey	Entity
martial music	Concept
Massive Attack	Entity
soft rock	Concept
Les Claypool	Entity
northern	Concept
Pink Floyd	Entity
funk rock	Concept
horn	Concept
kickdrum	Concept
glam rock	Concept
DJ Sharkey	Entity
contemporary folk	Concept
neo-soul	Concept
new age	Concept
surf rock	Concept
piccolo	Concept
clapper	Concept
turntablists	Concept
pedal	Concept
accordion	Concept
bass part	Concept
Iris	Entity
sarabande	Concept
kalimba	Concept
waltzes	Concept
andante	Concept
lead sheet	Concept
Elton John	Entity
fiddle	Concept
John Peel	Entity
disco music	Concept
Eminem	Entity
obligato	Concept
signature	Concept
rider	Concept
pavane	Concept
keyed trumpet	Concept
Hollywood	Entity
slide	Concept
Coil	Entity
Public Enemy	Entity
pop metal	Concept
harmonica	Concept
Bounce	Entity
strain	Concept
quote	Concept
Mackey Feary	Entity
operettas	Concept
Kenny Loggins	Entity
Angela McCluskey	Entity
timbales	Concept
musical arrangement	Concept
minuets	Concept
bass clarinet	Concept
serenade	Concept
negro spiritual	Concept
pastiche	Concept
bongo drum	Concept
folk song	Concept
country and western	Concept
hardcore	Concept
Ilosaarirock	Entity
cello	Concept
introit	Concept
ground	Concept
disney	Concept
zydeco	Concept
improvisation	Concept
freestyle	Concept
rap	Concept
solfege	Concept
reharmonization	Concept
Dance-rock	Concept
rondeau	Concept
crumhorn	Concept
Pakistani rock	Concept
