oil pollution	Concept
troll	Concept
RF modulator	Concept
Jean Piaget	Entity
sunshine	Concept
Anthony Caro	Entity
fuse	Concept
20th century	Concept
Palazzo Farnese	Entity
flipper	Concept
jerkin	Concept
louse	Concept
wagoner	Concept
trust company	Concept
strange quark	Concept
particle	Concept
Susannah York	Entity
view	Concept
Delta Theta Phi	Entity
Hannibal	Entity
instruction	Concept
diorama	Concept
dike	Concept
school building	Concept
Bashi Channel	Entity
lithium	Concept
bush	Concept
scutcheon	Concept
Phi Sigma Sigma	Entity
business software	Concept
tower	Concept
square sail	Concept
United States	Entity
Blithe Spirit	Entity
needlepoint	Concept
bunionectomy	Concept
joystick	Concept
nu metal	Concept
John Livingston	Entity
Animorphs	Entity
Uraniborg	Entity
nag	Concept
fumigation	Concept
interception	Concept
amazon	Concept
quads	Concept
Susan Strasberg	Entity
farm animal	Concept
Mokelumne Wilderness	Entity
conviction	Concept
surd	Concept
sub-interval	Concept
attenuator	Concept
Stokes drift	Concept
flavin	Concept
Flagship Studios	Entity
degree	Concept
raise	Concept
Ernest Lehman	Entity
psychedelic	Concept
Mae West	Entity
change-of-pace	Concept
Cherie Nowlan	Entity
Suzy Favor Hamilton	Entity
thread	Concept
ideal	Concept
cellulose	Concept
collection	Concept
Savonarola	Entity
pathfinder	Concept
interface	Concept
citizen	Concept
Equator	Entity
civil union	Concept
brewing	Concept
self-justification	Concept
imputation	Concept
lyceum	Concept
pension	Concept
sucralfate	Concept
response	Concept
Siliana	Entity
Fast Company	Entity
drumbeat	Concept
WinSCP	Entity
thiocyanate	Concept
carat	Concept
gannet	Concept
Mjolnir	Entity
giro	Concept
Tacitus	Entity
full-duplex	Concept
New Jersey	Entity
Elizabeth Eisenstein	Entity
bolster	Concept
Sam Rainsy	Entity
frond	Concept
palisade	Concept
rep	Concept
margin	Concept
penetrator	Concept
Tony Malaby	Entity
customer	Concept
market value	Concept
Unreal Engine	Entity
rhizome	Concept
Indonesia	Entity
hovel	Concept
flattop	Concept
smoothbore	Concept
John Munroe	Entity
Franco Corelli	Entity
short-term memory	Concept
snatch	Concept
Eteocles	Entity
Surdas	Entity
snooze	Concept
graphics	Concept
charlotte	Concept
Hurricane Claudette	Entity
VirtualDubMod	Entity
sou	Concept
Margaret Fuller	Entity
John Edward Taylor	Entity
mail	Concept
pointer	Concept
Winterthur	Entity
Plovdiv	Entity
aquamarine	Concept
invalid	Concept
shirt	Concept
expiration date	Concept
octillion	Concept
snow	Concept
Michelle Thomas	Entity
slugger	Concept
Austin	Entity
Tropical Storm Helene	Entity
jet stream	Concept
steppe	Concept
excommunication	Concept
engineering	Concept
Typhoon Xangsane	Entity
frame	Concept
truffle	Concept
waybill	Concept
Murat Zyazikov	Entity
bastinado	Concept
white water	Concept
Dorothy Richardson	Entity
protist	Concept
bank	Concept
magistrate	Concept
Liege	Entity
maple leaf	Concept
ounce	Concept
fibrillin	Concept
luffa	Concept
communization	Concept
thunder	Concept
res judicata	Concept
golden rule	Concept
racial profiling	Concept
decaf	Concept
Swimclub	Entity
Cnidaria	Concept
decentralisation	Concept
octopus	Concept
special forces	Concept
NGC 2264	Entity
fox	Concept
Jenny Oropeza	Entity
Long Tack Sam	Entity
allies	Concept
Aram I	Entity
tortilla chip	Concept
Judd Gregg	Entity
bonemeal	Concept
Fort Sumter	Entity
AI	Concept
metritis	Concept
dunce cap	Concept
glen	Concept
strategy	Concept
ancient philosophy	Concept
laser	Concept
Tony Trujillo	Entity
cotton candy	Concept
Robert Key	Entity
nitrification	Concept
Martha Blount	Entity
striatum	Concept
indenture	Concept
winner	Concept
posey	Concept
Vilfredo Pareto	Entity
grenadilla	Concept
shuttle	Concept
tornado	Concept
Tharsis	Entity
caldera	Concept
farmer	Concept
extropy	Concept
star	Concept
AltiVec	Entity
pawnbroker	Concept
Yapese	Concept
Venus	Entity
cingulate gyrus	Concept
lemon verbena	Concept
spinal fusion	Concept
conditionality	Concept
Elbridge Gerry	Entity
Endemic goitre	Concept
Arapaho	Entity
Walter Gropius	Entity
Oor Wullie	Entity
Josh Willis	Entity
Lake District	Entity
granadilla	Concept
cell culture	Concept
office automation	Concept
Compact Muon Solenoid	Entity
Harold W. Dodds	Entity
dual carriageway	Concept
Bill Koski	Entity
pod	Concept
La Dolce Musto	Entity
Brady Smith	Entity
straight	Concept
tendentiousness	Concept
first lady	Concept
oviduct	Concept
sight	Concept
rabidity	Concept
Asia	Entity
gasworks	Concept
termination	Concept
trade	Concept
triumvirate	Concept
adult	Concept
wire	Concept
Paul Philippe Cret	Entity
maliciousness	Concept
Ari Up	Entity
wrestle	Concept
bounty hunter	Concept
floorshow	Concept
evolutionary biologist	Concept
restaurant	Concept
animosity	Concept
belfry	Concept
dividend	Concept
Kim Il-sung University	Entity
investment	Concept
Now What	Entity
priority	Concept
longbow	Concept
sapote	Concept
history of science	Concept
pearl	Concept
inheritance	Concept
spats	Concept
phone call	Concept
guard	Concept
sister	Concept
copywriter	Concept
Meat Puppets	Entity
Devonian	Entity
teleconference	Concept
miscarriage of justice	Concept
actor	Concept
oligoastrocytoma	Concept
seamster	Concept
livery	Concept
Dodie Bellamy	Entity
convenience	Concept
cosmic dust	Concept
expedition	Concept
afterlife	Concept
Grani	Entity
Iceland	Entity
William Cowper	Entity
board	Concept
affection	Concept
USS Housatonic	Entity
Lawrence	Entity
observance	Concept
biotechnology	Concept
calmodulin	Concept
newsletter	Concept
cobblestone	Concept
pseudogout	Concept
Zimbabwean	Concept
tropical depression	Concept
ultramicroscope	Concept
escutcheon	Concept
dioxide	Concept
buckle	Concept
Nsanje	Entity
parents	Concept
Lyman	Entity
pe	Concept
witchgrass	Concept
settlement	Concept
guts	Concept
syzygy	Concept
test	Concept
walk	Concept
Antony Leung	Entity
Tibet	Entity
sparerib	Concept
photography	Concept
sanctuary	Concept
hacksaw	Concept
kid	Concept
Marcel Duchamp	Entity
mill	Concept
crosswind	Concept
soaker	Concept
James Hogg	Entity
diner	Concept
Game Boy Advance	Entity
literary critic	Concept
variety	Concept
railyard	Concept
Vorukh	Entity
register	Concept
green roof	Concept
devotion	Concept
relevancy	Concept
health facility	Concept
State Highway 12	Entity
sort	Concept
Indra	Entity
meningitis	Concept
Shoot the Dog	Entity
estimation	Concept
Irish	Entity
Miller	Entity
Ivete Sangalo	Entity
Zinc	Entity
Howard K. Smith	Entity
petition	Concept
twopence	Concept
form	Concept
Amsterdam Admirals	Entity
makeover	Concept
Dave Littlefield	Entity
parceling	Concept
credit card	Concept
agar	Concept
prescription	Concept
dollar	Concept
Nathan Lane	Entity
logical thinking	Concept
Michael Castleman	Entity
spam	Concept
Fredericksburg	Entity
Lander University	Entity
Clean Edge	Entity
Graduate House	Entity
Pusey	Entity
palette	Concept
Tropical Storm Cindy	Entity
writer	Concept
Phi Sigma Pi	Entity
25th Hour	Entity
Adobe Flash Lite	Entity
Dejan Bodiroga	Entity
antibody	Concept
Ieuaf	Entity
Seanad	Concept
babysitting	Concept
exercise	Concept
petrology	Concept
optative	Concept
parking	Concept
colugo	Concept
highschool	Concept
Giovanni da Verrazzano	Entity
Gabriel Guerra	Entity
hell	Concept
Pressburg	Entity
treasure map	Concept
Andronicus of Rhodes	Entity
Wilma Vaught	Entity
Louisiana	Entity
torsion	Concept
syllabication	Concept
formula	Concept
IronPython	Entity
Port Chester	Entity
shoulder	Concept
mestranol	Concept
queenfish	Concept
styrofoam	Concept
bulkhead	Concept
Hurricane Rita	Entity
pill	Concept
tropical storm	Concept
Hudson	Entity
clastic	Concept
chaff	Concept
Young	Entity
ewe	Concept
haulier	Concept
pinny	Concept
damages	Concept
Dionysius	Entity
point	Concept
department head	Concept
Murder One	Entity
door	Concept
rockfish	Concept
delay	Concept
inertia	Concept
This Love	Entity
Leonhard Euler	Entity
homeless	Concept
Prowler	Entity
sunspot	Concept
hyperboloid	Concept
Ansel Adams	Entity
wear	Concept
vicarious liability	Concept
metre	Concept
Manarola	Entity
tahini	Concept
hallelujah	Concept
surf	Concept
workplace	Concept
Mike Allen	Entity
pumpkin	Concept
sailing ship	Concept
John Hodiak	Entity
zephyr	Concept
acanthocephalan	Concept
switch	Concept
possession	Concept
archduke	Concept
Belt Line	Entity
St. Augustine	Entity
mangonel	Concept
science journalism	Concept
GuideStar	Entity
heller	Concept
Mossbank	Entity
roundhouse	Concept
wrestler	Concept
beef	Concept
Hany Farid	Entity
Knoxville	Entity
outlander	Concept
oat	Concept
consumption	Concept
teddy	Concept
teamster	Concept
chronicler	Concept
nuclear energy	Concept
activator	Concept
grand	Concept
Catscratch	Entity
Leipzig	Entity
homeostasis	Concept
St. Vitus	Entity
Secant	Concept
porphyrin	Concept
Moscow	Entity
Lugh	Entity
watershed	Concept
headmaster	Concept
John McPherson	Entity
conglomerate	Concept
Magnificent Mile	Entity
prime minister	Concept
azathioprine	Concept
Fudan University	Entity
lats	Concept
intermittent claudication	Concept
proprioception	Concept
Martelle	Entity
psychopathology	Concept
cocoa bean	Concept
influenza	Concept
frequence	Concept
proof	Concept
Como	Entity
Anna Magnani	Entity
DC	Concept
voltage divider	Concept
Pi Sigma Alpha	Entity
full stop	Concept
ten thousand	Concept
Tom Hanks	Entity
Aksu	Entity
James Mason	Entity
Earthsea	Entity
persecution	Concept
Larry Niven	Entity
handful	Concept
patchwork	Concept
dashi	Concept
prayer	Concept
article	Concept
Qir	Entity
residence hall	Concept
Pyrrhus	Entity
Blisland	Entity
William Jordan	Entity
maltreatment	Concept
Halo Wars	Entity
circuit	Concept
manslaughter	Concept
OpenOffice.org	Entity
Ernie	Entity
technophobia	Concept
club	Concept
search engine	Concept
interpellation	Concept
hospital	Concept
loom	Concept
sneeze	Concept
freightage	Concept
restrictiveness	Concept
Toots Hibbert	Entity
arbitrage	Concept
rosiness	Concept
brute	Concept
overhead	Concept
prince	Concept
University of Liverpool	Entity
Qarbon	Entity
general assembly	Concept
Myers-Briggs Type Indicator	Entity
Wiktionary	Entity
purslane	Concept
sustainability	Concept
running	Concept
space research	Concept
potassium iodide	Concept
cocktail	Concept
unloading	Concept
Orlando Sentinel	Entity
drug of abuse	Concept
lightning rod	Concept
Chef Menteur Pass	Entity
Amsterdam Internet Exchange	Entity
incorporation	Concept
hegemony	Concept
delta	Concept
saltire	Concept
docker	Concept
Kralendijk	Entity
digester	Concept
cash	Concept
John Drew	Entity
witchery	Concept
Quebec	Entity
Agrippina	Entity
radon	Concept
potter	Concept
ghee	Concept
Marjorie Garber	Entity
dhow	Concept
track	Concept
Prentiss	Entity
aircraft	Concept
repair	Concept
version	Concept
Bob Beers	Entity
Vera Nazarian	Entity
Alternative Tentacles	Entity
Mohave Community College	Entity
Bierstadt	Entity
White House	Entity
placebo effect	Concept
hacker	Concept
earl	Concept
Tim Tebow	Entity
blind	Concept
tricolour	Concept
oxalic acid	Concept
czar	Concept
phonics	Concept
abnegation	Concept
Neon Genesis Evangelion	Entity
envelopment	Concept
Lewis H. Morgan	Entity
capillary	Concept
Sam Crawford	Entity
spearmint	Concept
Hermes	Entity
cereal	Concept
Merovingian	Entity
seal	Concept
notebook computer	Concept
gypsum	Concept
squall line	Concept
finalization	Concept
bird	Concept
Taiwan Relations Act	Entity
retail	Concept
Fort Klamath	Entity
vaporization	Concept
Richard Barnes Mason	Entity
sun	Entity
French Broad River	Entity
Muhammad Ali Jinnah	Entity
Deputy	Concept
Bradbury Science Museum	Entity
ordinary	Concept
Urbana University	Entity
pipe	Concept
Old Glory	Entity
gamesmanship	Concept
Cymru	Entity
S4	Concept
bye-election	Concept
halfpenny	Concept
elopement	Concept
trailing	Concept
dwarf planet	Concept
Helen of Troy	Entity
immurement	Concept
Tim Dwight	Entity
tax	Concept
laburnum	Concept
MetroLink	Entity
Ellida	Concept
Isaiah	Entity
forum	Concept
Fyodor Dostoyevsky	Entity
character	Concept
City of Whitehorse	Entity
Constantius	Entity
Internet	Concept
escheat	Concept
acceptance	Concept
curling	Concept
BattleTech	Entity
Joseph Stalin	Entity
wiper motor	Concept
leveling	Concept
Lachaise	Entity
Valjean	Entity
breeze	Concept
Monster Magnet	Entity
domain	Concept
algebra	Concept
portraitist	Concept
video	Concept
kingbird	Concept
Jane Asher	Entity
Deck	Concept
subspecies	Concept
Sphagnum	Concept
Hurricane Epsilon	Entity
medical emergency	Concept
throw	Concept
gene	Concept
architecture	Concept
chairman	Concept
Tropical Storm Erika	Entity
LEGO	Entity
tebuconazole	Concept
smoke	Concept
rectory	Concept
pool	Concept
Meanjin	Entity
lepton	Concept
homophone	Concept
Sake	Entity
Gagandeep Singh	Entity
anycast	Concept
immodesty	Concept
fifty	Concept
slating	Concept
loot	Concept
Bevis Hillier	Entity
center	Concept
Buchenwald	Entity
Willow Street	Entity
tropopause	Concept
toll road	Concept
Darius Painter	Entity
aldicarb	Concept
Tarheel	Concept
Straight River	Entity
warship	Concept
windage	Concept
Swami Haridas	Entity
papillon	Concept
coupling	Concept
Timothy Leary	Entity
palm	Concept
blindfold	Concept
Coliseum	Entity
Cyprus	Entity
lousiness	Concept
faulting	Concept
fire service	Concept
Wellington Road	Entity
Solent	Entity
community	Concept
Bell	Entity
interdict	Concept
Cementation	Concept
seminar	Concept
stomach	Concept
turquoise	Concept
shellac	Concept
Nancy Milford	Entity
Julia Child	Entity
Showroom	Concept
sweetness	Concept
duke	Concept
tension	Concept
ball	Concept
Turonian	Entity
avenue	Concept
lipstick	Concept
spell	Concept
Auguste Rodin	Entity
deoxyribonucleic acid	Concept
platform	Concept
graduate	Concept
geode	Concept
Osbert Sitwell	Entity
postdoc	Concept
radish	Concept
Zelda	Entity
baba	Concept
shortsightedness	Concept
Siegfried Sassoon	Entity
accolade	Concept
environmental psychology	Concept
poetry	Concept
Jeff Francis	Entity
sawmill	Concept
Union Station	Entity
Loon	Entity
mycelium	Concept
Eliezer Yudkowsky	Entity
XML	Entity
tapir	Concept
emancipation	Concept
UDP Lite	Entity
synthesis	Concept
hypostasis	Concept
dicoumarol	Concept
stubble	Concept
George Soros	Entity
notion	Concept
Harold Volkmer	Entity
voyager	Concept
storm	Concept
lira	Concept
potato salad	Concept
crumpet	Concept
tooth	Concept
nuclear war	Concept
August	Concept
Sergei Shamba	Entity
Typhoon Lupit	Entity
noble	Concept
consummation	Concept
inch	Concept
Serpens	Entity
hair	Concept
perry	Concept
Bear Creek	Entity
curriculum	Concept
accreditation	Concept
turbofan	Concept
W. Browning	Entity
augmentation	Concept
The Mail	Entity
Mexico	Entity
song thrush	Concept
balance of power	Concept
Tellico Reservoir	Entity
Cradle Will Rock	Entity
Klaus Nomi	Entity
Fagopyrum	Concept
Melk	Entity
Chris Phillips	Entity
Slovenia	Entity
waxwork	Concept
packet filtering	Concept
royalist	Concept
offensive	Concept
island	Concept
Canyonlands	Entity
James Renwick	Entity
volcanic rock	Concept
ladino	Concept
lemongrass	Concept
knickers	Concept
breakwater	Concept
blazonry	Concept
financial aid	Concept
delicacy	Concept
religionism	Concept
shopping	Concept
radical feminism	Concept
suzerainty	Concept
Roger Fry	Entity
Scarlet Diva	Entity
feebleness	Concept
sphygmomanometer	Concept
nursery rhyme	Concept
supermajority	Concept
bridge	Concept
printing	Concept
Swansea	Entity
secular	Concept
Louisville	Entity
catechumen	Concept
oriflamme	Concept
sphinx	Concept
dealer	Concept
wheeler	Concept
stem-cell research	Concept
blunder	Concept
Middlesex Guildhall	Entity
editor	Concept
Texas	Entity
radio	Concept
Day One	Entity
sitagliptin	Concept
web	Concept
Robert Barefoot	Entity
Wang Xin	Entity
amaretto	Concept
Gram Parsons	Entity
commuter rail	Concept
Automatix	Entity
till	Concept
need	Concept
Cumberland Bay	Entity
stater	Concept
universal suffrage	Concept
POB	Concept
cricket	Concept
Serpens Caput	Entity
Charles Alexander	Entity
prince consort	Concept
department	Concept
avulsion	Concept
foreshadowing	Concept
greenmail	Concept
antioxidant	Concept
rail	Concept
powertrain	Concept
deposition	Concept
Stan Lee	Entity
laptop	Concept
brutalisation	Concept
bug	Concept
Poitiers	Entity
housing	Concept
Llaima	Entity
Maximum Carnage	Entity
Will Cotton	Entity
working capital	Concept
integration	Concept
designation	Concept
Eric Becklin	Entity
playwriting	Concept
Omiya	Entity
honesty	Concept
dexterity	Concept
business	Concept
snag	Concept
reconnoitering	Concept
cutlery	Concept
viral marketing	Concept
bigtooth aspen	Concept
abdication	Concept
suffragette	Concept
grapevine	Concept
monoclonal	Concept
Larderello	Entity
way out	Concept
imperialism	Concept
statice	Concept
prefix	Concept
Timeless	Entity
sapphire	Concept
workingman	Concept
mentor	Concept
literature	Concept
The Race	Entity
Nara	Entity
computational model	Concept
enlistment	Concept
bere	Concept
parliament	Concept
St. Bernard Software	Entity
Golden Gate Park	Entity
bell-bottoms	Concept
specular reflection	Concept
time-ball	Concept
Wicks	Entity
hit	Concept
screen	Concept
Alex Sink	Entity
sedative	Concept
Porsche	Entity
student council	Concept
Terrell High School	Entity
Catoctin Mountain Park	Entity
Hurricane Wilma	Entity
pleurisy	Concept
Mayon Volcano	Entity
derby	Concept
birdwatching	Concept
monoid	Concept
cheat	Concept
draft	Concept
lunchtime	Concept
deserter	Concept
downtime	Concept
kinetic theory	Concept
PricewaterhouseCoopers	Entity
Jane Clifton	Entity
penis bone	Concept
Muppet Babies	Entity
defeat	Concept
exposition	Concept
Intersection	Concept
journal	Concept
horsepower	Concept
sport shirt	Concept
adobe	Concept
climate	Concept
write-off	Concept
jacket	Concept
ulnar artery	Concept
riptide	Concept
Kazak	Concept
D-2	Entity
violin	Concept
Messi	Entity
certified check	Concept
Susan Wiggs	Entity
warlord	Concept
microcontroller	Concept
torture	Concept
assistance	Concept
spotting	Concept
Jehuda Reinharz	Entity
Gondi	Concept
marine	Concept
Cinnamomum	Concept
academic year	Concept
district court	Concept
permanent magnet	Concept
Derbyshire Peak	Entity
midfield	Concept
operation	Concept
foreign policy	Concept
tectonic uplift	Concept
metropolitan area	Concept
Rudolf Arnheim	Entity
advancement	Concept
human migration	Concept
IRA	Concept
brush-off	Concept
Exodus	Entity
medalist	Concept
Shahid Afridi	Entity
roaring	Concept
flavour	Concept
bothy	Concept
flak	Concept
hurdling	Concept
pragmatism	Concept
anglophile	Concept
economic policy	Concept
water balloon	Concept
Bernina Express	Entity
fat	Concept
transport	Concept
IBM 1620	Entity
TV	Concept
flirting	Concept
ruby	Concept
Men at Work	Entity
still-life	Concept
Cherryholmes	Entity
Umayyad Mosque	Entity
witness	Concept
wingspread	Concept
storyteller	Concept
Knowth	Entity
gegenschein	Concept
avant-garde	Concept
Bill Pullman	Entity
authoritarian regime	Concept
personal check	Concept
Jimmy Tingle	Entity
streetcar	Concept
November	Entity
round	Concept
slop	Concept
Wakashan	Concept
Reddit	Entity
paraffin	Concept
Surjit Singh Barnala	Entity
European Parliament	Entity
ethanol	Concept
Greg Germann	Entity
Act of Congress	Entity
grad	Concept
nonsmoker	Concept
carborundum	Concept
owner	Concept
shtup	Concept
contribution	Concept
insemination	Concept
customs	Concept
rainfall	Concept
Metal Gear Solid	Entity
Hero	Entity
Dara Horn	Entity
hometown	Concept
Jimmy Stewart	Entity
state of nature	Concept
bed rest	Concept
endeavour	Concept
Bennington	Entity
fils	Concept
back porch	Concept
Honeyd	Entity
negation	Concept
syneresis	Concept
prexy	Concept
Grigori Perelman	Entity
panorama	Concept
hydrogeology	Concept
orison	Concept
observation	Concept
coalition	Concept
boson	Concept
executive vice president	Concept
Kennedy	Entity
conspiracy	Concept
life history	Concept
Anthony Hopkins	Entity
sulfur dioxide	Concept
Heming	Entity
junk	Concept
Be Yourself	Entity
Newdale	Entity
Frankenstein	Entity
Newport Gwent Dragons	Entity
Tropical Storm Alpha	Entity
neurologist	Concept
escrow	Concept
preparation	Concept
telescope	Concept
Robert Solow	Entity
robber	Concept
crisis	Concept
potato	Concept
city wall	Concept
language	Concept
Sonora	Entity
dragnet	Concept
Matt Dean	Entity
Diocletian	Entity
eternity	Concept
dinner	Concept
prairie cordgrass	Concept
song	Concept
Jon Cassar	Entity
lava dome	Concept
convert	Concept
Ryan Hall	Entity
Comet Hale-Bopp	Entity
grandee	Concept
John Barclay	Entity
convertibility	Concept
flood	Concept
emergence	Concept
Michigan	Entity
Frank Harris	Entity
ergotamine	Concept
heritage	Concept
ethanal	Concept
antagonism	Concept
ridge	Concept
potpourri	Concept
century	Concept
Poeciliopsis	Concept
Before Dark	Entity
signal	Concept
extramarital sex	Concept
Kovel	Entity
tenpence	Concept
Lars Leksell	Entity
Phrygian cap	Concept
Beijing	Entity
affectionateness	Concept
Alexandre Gustave Eiffel	Entity
saprolite	Concept
Mount St. Helens	Entity
Harmonia axyridis	Concept
immateriality	Concept
wing	Concept
maharaja	Concept
trade embargo	Concept
small	Concept
Ken Russell	Entity
Oxford	Entity
committee	Concept
rematch	Concept
buffer	Concept
comic	Concept
Hurricane Fabian	Entity
gdbserver	Concept
freedman	Concept
infatuation	Concept
flavivirus	Concept
James Kirchick	Entity
warrantor	Concept
nationalization	Concept
ecosystem	Concept
tapis	Concept
service	Concept
neck	Concept
Cynthia McKinney	Entity
jackhammer	Concept
Bharata	Entity
Health Sciences Library	Entity
Jason Harris	Entity
religion	Concept
issuer	Concept
The Seven	Entity
Republic of Turkey	Entity
chapter	Concept
ossification	Concept
authentication	Concept
Standerton	Entity
transmission	Concept
Jackie Mittoo	Entity
PubMed	Entity
silhouette	Concept
covenant	Concept
senior status	Concept
Mario Kart DS	Entity
designer	Concept
inspection	Concept
Manassas	Entity
pipeline	Concept
Matthew Murphy	Entity
capsule	Concept
ox	Concept
ground	Concept
totient	Concept
magnet	Concept
advocacy	Concept
McCormick County	Entity
family therapy	Concept
declaration	Concept
fleur-de-lis	Concept
Trimble	Entity
horsehair	Concept
Manage	Entity
TimeShift	Entity
wind	Concept
Monash Freeway	Entity
threat	Concept
Supersonics	Entity
pula	Concept
backstay	Concept
burning	Concept
Phage	Entity
serial	Concept
capability	Concept
Cancun	Entity
assertion	Concept
harrow	Concept
entente	Concept
ultranationalism	Concept
release	Concept
Copper oxide	Concept
Susanna Clarke	Entity
Local Group	Entity
chip	Concept
Frank Henry	Entity
camlet	Concept
column	Concept
Zhu Di	Entity
Mark Tully	Entity
letter	Concept
mouse	Concept
hostile fire	Concept
proteolysis	Concept
left	Concept
heedfulness	Concept
Burger King	Entity
Tau Kappa Epsilon	Entity
Neil Gillman	Entity
Save Mart Center	Entity
make	Concept
incandescence	Concept
alb	Concept
Augustine Volcano	Entity
baronetcy	Concept
taxi	Concept
urinary bladder	Concept
Vietnam	Entity
Jesse Alexander	Entity
strangulation	Concept
fish	Concept
chief research officer	Concept
punishment	Concept
Dorion Sagan	Entity
stripe	Concept
supervision	Concept
verbal abuse	Concept
quake	Concept
reminiscence	Concept
vibe	Concept
grafting	Concept
law	Concept
lunch	Concept
granularity	Concept
Chevrolet SSR	Entity
Bronze Horseman	Entity
Analytical Engine	Entity
mark	Concept
lava	Concept
compact disc	Concept
pollution	Concept
samurai	Concept
pecan	Concept
nonage	Concept
playlist	Concept
jingoism	Concept
soil pipe	Concept
Tutankhamun	Entity
foolishness	Concept
Winsor School	Entity
dicky	Concept
riel	Concept
osteocyte	Concept
empire	Concept
Hamlet	Entity
sidestroke	Concept
Simon Walker	Entity
fertility rate	Concept
Isle of Arran	Entity
MXML	Entity
compound	Concept
Jay Cocks	Entity
Reckless Kelly	Entity
charity	Concept
private eye	Concept
medical care	Concept
road	Concept
blockade	Concept
cotton flannel	Concept
apartment	Concept
Michael Owen	Entity
Middle Ages	Entity
pomegranate	Concept
residence time	Concept
eversion	Concept
State Highway 17	Entity
Make the Grade	Entity
White Star	Entity
Gerry Davis	Entity
self-confidence	Concept
representative	Concept
veratrum	Concept
yesterday	Concept
Giovanni Bellini	Entity
Montlake Bridge	Entity
grant	Concept
New Orleans	Entity
Hurricane Charley	Entity
biology	Concept
outfit	Concept
Arthur Ashe	Entity
summit	Concept
counterpane	Concept
photolithography	Concept
Thomas Phillipps	Entity
heptose	Concept
transit	Concept
disc	Concept
Gainesville	Entity
Platt	Entity
complicatedness	Concept
RELCOM	Entity
inverse distance weighting	Concept
Raoul Dufy	Entity
recission	Concept
LRRK2	Entity
Chromehounds	Entity
Jump Cut	Entity
confederacy	Concept
happening	Concept
Seekonk	Entity
coder	Concept
overall	Concept
pasqueflower	Concept
Theodore Roethke	Entity
firm	Concept
Panthera pardus	Concept
turnstile	Concept
wand	Concept
Cori	Entity
nonverbal communication	Concept
preaching	Concept
success	Concept
source	Concept
tubing	Concept
route	Concept
lunation	Concept
beam	Concept
betaine	Concept
Herodian	Entity
Oakland City Hall	Entity
Slowhand	Entity
Dungeon Master	Entity
one-way street	Concept
Paynes Creek	Entity
employee	Concept
chuck steak	Concept
hillock	Concept
zabaglione	Concept
seaquake	Concept
Win Maung	Entity
subway	Concept
blacktopping	Concept
harvesting	Concept
Cambridge	Entity
paragonite	Concept
intransitivity	Concept
metadata	Concept
shipping	Concept
dishwater	Concept
unsafe abortion	Concept
rationing	Concept
chess	Concept
Maxims	Entity
StarCraft	Entity
spring	Concept
judgment	Concept
GraphicConverter	Entity
actuator	Concept
chai tea	Concept
tactic	Concept
pellicle	Concept
dam	Concept
adage	Concept
spending	Concept
Verrier Elwin	Entity
transportation	Concept
rejection	Concept
John Passmore	Entity
fishmeal	Concept
conformist	Concept
Ukraine	Entity
aerofoil	Concept
Leslie Caron	Entity
El Nino	Entity
gamboge	Concept
solid	Concept
barley	Concept
day	Concept
La Veta Pass	Entity
animation	Concept
smallpox virus	Concept
burgh	Concept
Wii	Entity
eponychium	Concept
mongoose	Concept
cypher	Concept
byroad	Concept
debenture	Concept
Renata Kallosh	Entity
Martin Brest	Entity
bread	Concept
gusset	Concept
Cortes	Entity
acquiescence	Concept
northwester	Concept
prerogative	Concept
rap music	Concept
weapon	Concept
Chicago	Entity
autoresponder	Concept
fosterling	Concept
smut	Concept
Denning	Entity
budget	Concept
vendue	Concept
Mel Gibson	Entity
vindication	Concept
flashlight	Concept
hauling	Concept
rubble	Concept
Copernic	Entity
navigator	Concept
Aesculapius	Entity
anticlimax	Concept
washing	Concept
timidness	Concept
mode	Concept
green olive	Concept
Seema Biswas	Entity
drinking	Concept
baguette	Concept
liquid nitrogen	Concept
Susan B. Anthony	Entity
recall	Concept
VersionTracker	Entity
overflow	Concept
Ceuta	Entity
stationmaster	Concept
Scott	Entity
archeologist	Concept
balk	Concept
list	Concept
journalist	Concept
episode	Concept
sod	Concept
ozone	Concept
delegacy	Concept
society	Concept
capture	Concept
chaldron	Concept
pragmatics	Concept
railroad	Concept
village	Concept
progressive	Concept
Jemison	Entity
sheepshead	Concept
Lutyens	Entity
yaupon holly	Concept
cistron	Concept
selector	Concept
nutrition	Concept
cloister	Concept
Mitchell Brown	Entity
snowfall	Concept
Yellowstone Caldera	Entity
terrier	Concept
bibliographic database	Concept
Invermay	Entity
Gerrard Winstanley	Entity
Hurricane Dennis	Entity
Stardock	Entity
rose	Concept
Watergate	Entity
recommendation	Concept
Roy Hattersley	Entity
coffee	Concept
Yahoo	Entity
regeneration	Concept
gerontocracy	Concept
course	Concept
nude	Concept
sharecropper	Concept
Michael Nielsen	Entity
Dalbergia melanoxylon	Concept
ninepence	Concept
van	Concept
hero	Concept
bear	Concept
surprise	Concept
DirectX	Entity
Katharine Hepburn	Entity
north	Concept
Dirac	Entity
Griselda	Entity
leger	Concept
John Osborne	Entity
lofepramine	Concept
UN	Entity
Sidney R. Yates	Entity
director	Concept
Henry Allan	Entity
Dairen	Entity
horizontal bar	Concept
puffing	Concept
arms	Concept
slut	Concept
SpamBayes	Entity
stake	Concept
human	Concept
South East Wales	Entity
Linum	Concept
sigma	Concept
