hostility	aggression	rage
optical device
firm	corporation	company	partnership	venture	enterprise	concern
picture	musical composition	moving picture	song	dance band	musical work	piece of music	show	pic	vocal	track	musical group	moving-picture show	movie	music group
rational motive
town	county town	public administration
religious person	person	christian
drinkable	tea	drink	fluid	beverage
mammal	antelope	animal
body armor
sociology	warfare	intelligence assessment	intelligence operation	experiment	warring	intelligence activity	military unit	war
information processing system	tissue layer	communications system	network service	communication system	computer networking	anatomical structure	computer code	biological membrane	component-based software engineering	telecommunication system	data system	electronic network	fabric	information systems	network	computer network	software component	body structure	textile	connection	information system	physical system	membrane	information network	interconnection
equipment	electronic equipment	video equipment	photographic equipment	instrument
dike	dyke
salt	dirt
specifications	olympiad	athletic competition	type of sport	jock	competitor	contest	sportswoman	orbit period	person	contestant	track and field	sportsperson
move	reaching
human language	creole language	language
agreement	concord	alinement	coalition	alignment	understanding
denseness	storm
glycan
skillfulness
wrongful conduct	misconduct	injury	wrongdoing
particle detector	research	scientific research
computer programme	shell	coding system	fundamental interaction	computer program
knowing	intuition	perception	sensitivity	understanding	sensibility	sensitiveness
illness	bodily process	disaster	physical property	magnitude relation	evidence	reflex response	fighting	quantitative relation	physical phenomenon	prostration	natural phenomenon	phenomenon	acceleration	ratio	jeopardy	astonishment	collapse	surprise	inclination	impact	cumulation	proclivity	reaction	impinging	reason	heap	response	observable	peril	predisposition	disorder	proneness	physiological reaction	magnitude	indication	unconditioned reflex	dimensionless quantity
specifications	score
portion	component	score
table	measurement	pressure unit	measure	counter	implement	instrument	block	support	barrier	obstruction	obstacle
rejection	social rejection
blow	motion	animal locomotion	effect
current of air	atmospheric phenomenon	atmospheric condition	air current	weather condition	natural phenomenon	wind	current	phenomenon
cast	toy	fundamental measure
function	operator	natural phenomenon
equipment	game equipment
ungulate	hoofed mammal	perissodactyl	traveller	traveler	mammal	equus
liqueur	alcoholic beverage	beverage	alcoholic drink	drink	fluid
written language	software program	computer software	song	software framework	brand	music group	legal name	code	computer program	computer programme	communication medium	software	computer code	software package	island	coding system	data-storage medium	musical group	musical organization	written communication	storage medium	knowledge organization
electrical device	instrument	body part	tentacle	outgrowth
mapmaking	direction	cartography	spatial relation	cardinal direction
physician	medico	health professional	primary care provider	health science	doctor	medical doctor	doc	health care provider	medical practitioner	person	medical man	dr.	medical specialist
social function	affair	ball	show	masquerade	masque	mask	social occasion	social event	party	function	occasion	group event	masquerade party	social gathering
money	payment	cost	spending
person	actor
leader	master	person
weight unit	metric unit
primate	mammal	animal
ship transport	haircut	hairdo	hairstyle	haircutting	transportation	trend	hair style	passenger transport	hair styling	watercraft	vehicle	vessel	ship	military unit	mode of transport	transport
motion	rousing	state	joyousness	joyfulness	joy	emotional arousal
