honorable discharge	Concept
McCormick County	Entity
Arthur Ashe	Entity
Cooperation and Development	Entity
Hurricane Wilma	Entity
flowage	Concept
sod	Concept
natural resources	Concept
Shahid Afridi	Entity
guerilla	Concept
immodesty	Concept
Forest Way	Entity
emancipation	Concept
Saqqaq	Entity
World War II	Entity
Middle Ages	Entity
streptomycin	Concept
Cortes	Entity
corneum	Concept
clopyralid	Concept
UDP Lite	Entity
still-life	Concept
inquisitor	Concept
Sylvette	Entity
bread	Concept
discharge	Concept
rose	Concept
excitement	Concept
exculpation	Concept
rejection	Concept
certificate	Concept
offensive	Concept
AI	Concept
Kirk Fordice	Entity
white coat	Concept
Stardock	Entity
ironing	Concept
Gabriel Guerra	Entity
ranch	Concept
steenbok	Concept
Monty Python	Entity
share	Concept
sucralfate	Concept
nonsmoker	Concept
arbitrage	Concept
AltiVec	Entity
photography	Concept
Gerrard Winstanley	Entity
acanthocephalan	Concept
farming	Concept
festival	Concept
Salang Tunnel	Entity
louse	Concept
restitution	Concept
precision	Concept
Jane Asher	Entity
shamrock	Concept
seafloor	Concept
activator	Concept
pollution	Concept
aqueduct	Concept
Typhoon Saomai	Entity
commoner	Concept
Derbyshire Peak	Entity
tau neutrino	Concept
Pressburg	Entity
St. Edward	Entity
dragonfly	Concept
ball	Concept
environment	Concept
till	Concept
gasworks	Concept
Siliana	Entity
forum	Concept
honesty	Concept
kingdom	Concept
Cherie Nowlan	Entity
preserve	Concept
victimization	Concept
immurement	Concept
Susan Strasberg	Entity
Comfortably Numb	Entity
lofepramine	Concept
language	Concept
power point	Concept
imposture	Concept
pastry cook	Concept
hacker	Concept
click	Concept
Roy Hattersley	Entity
volcanology	Concept
State Highway 17	Entity
market research	Concept
capital	Concept
duke	Concept
sidestroke	Concept
limousine	Concept
Feral Interactive	Entity
editor in chief	Concept
Compact Muon Solenoid	Entity
henbit	Concept
baronetcy	Concept
trade embargo	Concept
Clean Edge	Entity
Delta Theta Phi	Entity
Monash Freeway	Entity
flow	Concept
Port Chester	Entity
Haven	Entity
Sidney R. Yates	Entity
powertrain	Concept
Bennington	Entity
episode	Concept
Bislama	Entity
Micronesia	Entity
overflow	Concept
Bierstadt	Entity
decomposition	Concept
grounds	Concept
Umayyad Mosque	Entity
Martha Blount	Entity
provision	Concept
quickening	Concept
envelopment	Concept
Fayette County	Entity
Riptide	Entity
Johan Remkes	Entity
artemisia	Concept
brewing	Concept
Sphagnum	Concept
James Kirchick	Entity
domain	Concept
viniculture	Concept
James Sallis	Entity
library	Concept
Universidad	Entity
Dorset	Entity
South Kensington	Entity
heedfulness	Concept
community	Concept
selector	Concept
open source	Concept
Tropical Storm Erika	Entity
Sonora	Entity
parameter	Concept
rhizome	Concept
coder	Concept
antibody	Concept
Joe Price	Entity
monoid	Concept
keyboardist	Concept
kid	Concept
Hany Farid	Entity
pula	Concept
admittance	Concept
convertibility	Concept
Llaima	Entity
song	Concept
Windows	Entity
global warming	Concept
Campo San Polo	Entity
coordinator	Concept
fils	Concept
Mason & Dixon	Entity
archduke	Concept
angular momentum	Concept
quake	Concept
seaquake	Concept
Valjean	Entity
pathfinder	Concept
Washington	Entity
terrier	Concept
multimeter	Concept
subsoil	Concept
Belfast Lough	Entity
metre	Concept
malediction	Concept
Otto von Habsburg	Entity
heaven	Concept
9mm	Entity
bomber	Concept
September	Entity
Xpdf	Entity
potato	Concept
rookery	Concept
consultant	Concept
graduate	Concept
designer	Concept
Taco Cabana	Entity
ox	Concept
nonverbal communication	Concept
basin	Concept
screen	Concept
crosswind	Concept
zabaglione	Concept
Health Sciences Library	Entity
lift	Concept
gannet	Concept
prepositional phrase	Concept
ordinary	Concept
links	Concept
writer	Concept
headshot	Concept
perfidiousness	Concept
citizen	Concept
Cecilia	Entity
invalid	Concept
write-off	Concept
magnet	Concept
price reduction	Concept
Loon	Entity
radon	Concept
paragonite	Concept
priority	Concept
Itsu	Entity
shock	Concept
octopus	Concept
wicketkeeper	Concept
management	Concept
equitation	Concept
Hurricane Fabian	Entity
synapse	Concept
lira	Concept
dirham	Concept
blindfold	Concept
nationalization	Concept
Tasman Glacier	Entity
inch	Concept
immunologist	Concept
Manarola	Entity
eternity	Concept
Washburn High School	Entity
door	Concept
pusher	Concept
rap music	Concept
Barney Bigard	Entity
lemon verbena	Concept
dioxide	Concept
navigator	Concept
Gram Parsons	Entity
afterlife	Concept
Before Dark	Entity
volcanic rock	Concept
Zimbabwean	Concept
paragraph	Concept
snooze	Concept
solid	Concept
Kralendijk	Entity
shift	Concept
inclemency	Concept
Point Lillias	Entity
Leonhard Euler	Entity
sedative	Concept
ossification	Concept
aldicarb	Concept
Dionysius	Entity
reporter	Concept
metadata	Concept
dishwater	Concept
Michigan	Entity
general	Concept
conversion	Concept
fat	Concept
economic policy	Concept
lappet	Concept
Mokelumne Wilderness	Entity
computational model	Concept
clerisy	Concept
Union Station	Entity
truth	Concept
Earthsea	Entity
medalist	Concept
PricewaterhouseCoopers	Entity
bank	Concept
coxswain	Concept
Mark Tully	Entity
Ron Donagi	Entity
grapevine	Concept
Messi	Entity
suffragette	Concept
stability	Concept
Winterthur	Entity
shuttle	Concept
Konstantin Tsiolkovsky	Entity
Standerton	Entity
Bomberman	Entity
Newdale	Entity
Day One	Entity
atmosphere	Concept
course	Concept
taxi	Concept
defiance	Concept
coupling	Concept
Mister Johnson	Entity
flooding	Concept
Nadezhda von Meck	Entity
David Gustafson	Entity
saltire	Concept
Carlos Frenk	Entity
pet shop	Concept
fresco	Concept
hell	Concept
clerid	Concept
Tarleton	Entity
treasure map	Concept
medical emergency	Concept
MathWorks	Entity
tax haven	Concept
Unix shell	Concept
Manage	Entity
penetrator	Concept
pragmatism	Concept
trailing	Concept
studio	Concept
Zelda	Entity
Theodore Roethke	Entity
day	Concept
tapis	Concept
Jimmy Stewart	Entity
board	Concept
failure rate	Concept
Shoot the Dog	Entity
Monster Magnet	Entity
grand	Concept
carbon	Concept
Circle Jerks	Entity
ulnar artery	Concept
Creative	Entity
John Pankow	Entity
complicatedness	Concept
Helene Deutsch	Entity
Surjit Singh Barnala	Entity
balance of power	Concept
crumpet	Concept
compact disc	Concept
school year	Concept
portraitist	Concept
lats	Concept
jackhammer	Concept
Louisville	Entity
visibility	Concept
Goonellabah	Entity
VirtualDubMod	Entity
azathioprine	Concept
bastinado	Concept
indenture	Concept
local government	Concept
marriage	Concept
birdwatching	Concept
Savonarola	Entity
Analytical Engine	Entity
streptomyces	Concept
Dale	Entity
Adam Crosthwaite	Entity
interleaf	Concept
grenade	Concept
breve	Concept
tenpence	Concept
Wisconsin	Entity
San Andreas	Entity
penis bone	Concept
kidney transplantation	Concept
secular	Concept
complaint	Concept
tableware	Concept
HMAS Perth	Entity
Straight River	Entity
Korea	Entity
Michelle Thomas	Entity
homeostasis	Concept
retribution	Concept
calumniation	Concept
German mark	Concept
Tony Malaby	Entity
rollercoaster	Concept
bird	Concept
surd	Concept
BattleTech	Entity
cereal	Concept
GraphicConverter	Entity
hillock	Concept
recission	Concept
palomino	Concept
Poland	Entity
Bear Creek	Entity
Dustin Hoffman	Entity
leger	Concept
classifier	Concept
dulcimer	Concept
liquidation	Concept
potter	Concept
walk	Concept
Capcom	Entity
fish	Concept
Plovdiv	Entity
Bowhead whale	Concept
cesarean delivery	Concept
questionnaire	Concept
termination	Concept
lanugo	Concept
royalist	Concept
Joseph Rodman Drake	Entity
acquiescence	Concept
pottery	Concept
chest of drawers	Concept
Malmo	Entity
playwriting	Concept
Typhoon Xangsane	Entity
Katharine Hepburn	Entity
palm	Concept
Hypnerotomachia Poliphili	Entity
samurai	Concept
sorcerer	Concept
petrology	Concept
star	Concept
Coliseum	Entity
misfire	Concept
pin money	Concept
Lewis H. Morgan	Entity
State Highway 12	Entity
literature	Concept
full stop	Concept
Newport Gwent Dragons	Entity
earthquake	Concept
waxwork	Concept
neurologist	Concept
nuclear energy	Concept
Fagopyrum	Concept
Andrew McCormick	Entity
prayer	Concept
Matthew Murphy	Entity
calcium	Concept
desiccation	Concept
Ph.D.	Concept
storyteller	Concept
Ivete Sangalo	Entity
Franco Corelli	Entity
bioenergy	Concept
human migration	Concept
Jack Lengyel	Entity
coma	Concept
small	Concept
search engine	Concept
galoshes	Concept
Amsterdam Admirals	Entity
delicacy	Concept
roaring	Concept
breakfast	Concept
sailing ship	Concept
pool	Concept
leopard cat	Concept
dam	Concept
silhouette	Concept
Kingdom Hospital	Entity
environmental psychology	Concept
stack	Concept
manslaughter	Concept
asterism	Concept
spare	Concept
colugo	Concept
Tarawa	Entity
Willow Street	Entity
Thanatos	Entity
sawmill	Concept
Minnamurra	Entity
True Life	Entity
public service	Concept
Vernon Jarrett	Entity
organdy	Concept
Orange	Entity
program	Concept
bothy	Concept
dirt	Concept
word	Concept
history of science	Concept
chowder	Concept
rabidity	Concept
abdication	Concept
station	Concept
wallop	Concept
bearing	Concept
Macklin	Entity
electron microscopy	Concept
stairway	Concept
Serpens Caput	Entity
Charles Alexander	Entity
Paul Philippe Cret	Entity
Talcott Parsons	Entity
binder	Concept
Funen	Entity
Lido	Entity
restriction fragment	Concept
Robert De Niro	Entity
Ilex cassine	Concept
viscometry	Concept
capsule	Concept
wrestle	Concept
Grani	Entity
perpendicular	Concept
buckle	Concept
shoe	Concept
Port Huron	Entity
Hurrican	Entity
straight	Concept
sport	Concept
dance	Concept
ostracism	Concept
actor	Concept
subject	Concept
Constantius	Entity
Grimm	Entity
height	Concept
lepton	Concept
docker	Concept
Carlos Tosca	Entity
professional designation	Concept
aridity	Concept
pons	Concept
regiment	Concept
pedagogue	Concept
office automation	Concept
Pakistan	Entity
Dara Horn	Entity
wrestler	Concept
Milton Shapp	Entity
law	Concept
Rome	Entity
avulsion	Concept
Lyman	Entity
RTLinux	Entity
threat	Concept
longbow	Concept
Phrygian cap	Concept
pane	Concept
shopping	Concept
Paul Mellars	Entity
Harold Volkmer	Entity
Roos	Entity
edger	Concept
unloading	Concept
steppe	Concept
Oklahoma Corporation Commission	Entity
Solent	Entity
Robert Barefoot	Entity
Bernard Laporte	Entity
Aksu	Entity
lie detector	Concept
lordship	Concept
RF modulator	Concept
plantation	Concept
way out	Concept
hacksaw	Concept
endeavour	Concept
antioxidant	Concept
John Passmore	Entity
Showroom	Concept
Robert Trivers	Entity
rotunda	Concept
placebo effect	Concept
mould	Concept
snow	Concept
hyperlink	Concept
perry	Concept
Cinnamomum	Concept
A1 motorway	Entity
William S. Harney	Entity
W. Browning	Entity
UN	Entity
complement	Concept
Urbana University	Entity
épée	Concept
flattop	Concept
indisposition	Concept
Wii	Entity
kaon	Concept
risotto	Concept
intransitivity	Concept
observance	Concept
strategy	Concept
dentist	Concept
windage	Concept
Intersection	Concept
shambles	Concept
acre	Concept
single tax	Concept
liquid	Concept
ground	Concept
gatekeeper	Concept
Copernic	Entity
Gagandeep Singh	Entity
stage	Concept
Act of Congress	Entity
Ernest Lehman	Entity
flavour	Concept
wood	Concept
Dhiren Barot	Entity
chips	Concept
voyager	Concept
Buchenwald	Entity
footman	Concept
Leon Battista Alberti	Entity
list	Concept
macroeconomics	Concept
Mel Gibson	Entity
mug	Concept
Arapaho	Entity
religionism	Concept
Matthew Flinders	Entity
Patrizia Ciofi	Entity
laburnum	Concept
reflex response	Concept
smew	Concept
malware	Concept
Mount St. Helens	Entity
interface	Concept
Breidenbach	Entity
Johnny Ramone	Entity
Brady Smith	Entity
synthesis	Concept
river	Concept
Bill Douglass	Entity
White Star	Entity
chronicler	Concept
freethought	Concept
issuer	Concept
supervolcano	Concept
continuum	Concept
pud	Concept
proton pump	Concept
student council	Concept
Josef Gingold	Entity
engram	Concept
camelpox	Concept
Chevrolet SSR	Entity
baby tears	Concept
Middlesex Guildhall	Entity
Timothy Leary	Entity
Halevi	Entity
top side	Concept
horseman	Concept
magnetic storage	Concept
scoutmaster	Concept
Leonidas	Entity
seignior	Concept
mugwump	Concept
res judicata	Concept
knickers	Concept
IBM 1620	Entity
formula	Concept
supernaturalism	Concept
impression	Concept
banyan	Concept
decentralisation	Concept
climate	Concept
Don Baldwin	Entity
Vat Phou	Entity
Grosgrain	Concept
flood	Concept
spell	Concept
hand drill	Concept
magnetic dipole	Concept
jeopardy	Concept
David Ball	Entity
Poeciliopsis	Concept
Anna Lindh	Entity
bush	Concept
feebleness	Concept
studbook	Concept
peasant	Concept
John Romer	Entity
growth	Concept
General Intelligence Directorate	Entity
raise	Concept
supervision	Concept
psychedelic	Concept
TimeShift	Entity
tension	Concept
Ellida	Concept
Hurricane Claudette	Entity
Turistas	Entity
snowfall	Concept
mechanics	Concept
austral	Concept
referral	Concept
Carlo Levi	Entity
ruling	Concept
franchise	Concept
William Cowper	Entity
CISC	Concept
Mariamman	Entity
dexterity	Concept
cent	Concept
senior	Concept
James Renwick	Entity
City of London	Entity
mods	Concept
Jon Clardy	Entity
derogation	Concept
neurohypophysis	Concept
spring	Concept
bere	Concept
tenement	Concept
Long Tack Sam	Entity
RVF	Concept
Drawing Restraint 9	Entity
convenience	Concept
dollar	Concept
Elizabeth Eisenstein	Entity
radio	Concept
silver	Concept
Jon Cassar	Entity
inverse distance weighting	Concept
viper	Concept
Fort Sumter	Entity
guard	Concept
interpellation	Concept
staginess	Concept
radish	Concept
ground level	Concept
Boulder Creek	Entity
square sail	Concept
arboriculture	Concept
Chuck Schumer	Entity
vindication	Concept
bibliographic database	Concept
prince consort	Concept
Valeria Golino	Entity
arm	Concept
credit card	Concept
full-duplex	Concept
Sigrid Nunez	Entity
fosterling	Concept
time	Concept
accounting	Concept
bolster	Concept
D'Arcy Wentworth	Entity
ounce	Concept
overall	Concept
Cyprus	Entity
Zinc	Entity
wrongness	Concept
alb	Concept
baba	Concept
WITI	Entity
debenture	Concept
close combat	Concept
sociology department	Concept
Caligula	Entity
defeat	Concept
Giovanni da Verrazzano	Entity
investment	Concept
detour	Concept
collage	Concept
Serpens	Entity
telescope	Concept
open proxy server	Concept
wage	Concept
demonstration	Concept
pulse	Concept
St. Augustine	Entity
Austin	Entity
Brasilia	Entity
fibrillin	Concept
impromptu	Concept
Rheal Cormier	Entity
Cynthia McKinney	Entity
fire	Concept
pipeline	Concept
Gondi	Concept
Endemic goitre	Concept
relative price	Concept
Hurricane Charley	Entity
house	Concept
Quercus ilex	Concept
far left	Concept
sunspot	Concept
soul mate	Concept
geode	Concept
ten thousand	Concept
pungency	Concept
serial	Concept
bunionectomy	Concept
persecution	Concept
Golden Gate Park	Entity
barley	Concept
prefix	Concept
Laksar	Entity
George Lamming	Entity
John Edward Taylor	Entity
debt	Concept
Herodian	Entity
Abutilon theophrasti	Concept
puffing	Concept
miscarriage of justice	Concept
urus	Concept
SpamBayes	Entity
William Jordan	Entity
Introducing	Entity
granularity	Concept
empennage	Concept
affection	Concept
rubbing alcohol	Concept
yawl	Concept
accessibility	Concept
praise	Concept
preparation	Concept
endarteritis	Concept
neck	Concept
octillion	Concept
poundage	Concept
conformist	Concept
King	Entity
poet	Concept
blank	Concept
prison	Concept
Virtual Console	Entity
Chromosome 9	Entity
flirting	Concept
Thomas Phillipps	Entity
bounty hunter	Concept
capture	Concept
makeover	Concept
reminiscence	Concept
dress	Concept
Reddit	Entity
Suzy Favor Hamilton	Entity
Jonathan Freedland	Entity
chaff	Concept
delay	Concept
Sino-Japanese War	Entity
condition	Concept
Mexico	Entity
inheritance	Concept
boatlift	Concept
weather	Concept
differential	Concept
Los Angeles	Entity
exposition	Concept
pasqueflower	Concept
Aram I	Entity
greywacke	Concept
Deep learning	Concept
card index	Concept
editorial	Concept
pumpkin	Concept
IronPython	Entity
property owner	Concept
oligoastrocytoma	Concept
breechcloth	Concept
violin	Concept
Zhu Di	Entity
blackface	Concept
conscience	Concept
run batted in	Concept
relevancy	Concept
Isaiah	Entity
covenant	Concept
platform	Concept
sharecropper	Concept
camlet	Concept
oil well	Concept
diabetic nephropathy	Concept
picture	Concept
drumbeat	Concept
expedition	Concept
palette	Concept
Transportation	Entity
airport	Concept
puzzler	Concept
groundnut	Concept
Angostura Reservoir	Entity
cascade	Concept
Internet	Concept
economic growth	Concept
porphyrin	Concept
grant	Concept
summerhouse	Concept
high commissioner	Concept
infrastructure	Concept
dhole	Concept
reliability	Concept
Chromehounds	Entity
ecosystem	Concept
signal	Concept
Craig Anderson	Entity
loaf	Concept
carbon dioxide	Concept
lag	Concept
capillary	Concept
postdoc	Concept
Edmund Burke	Entity
Coinage Act	Entity
RELCOM	Entity
cusp	Concept
Fuzion Frenzy 2	Entity
suer	Concept
junkware	Concept
Bill Wise	Entity
Yahoo	Entity
city wall	Concept
Hero of Alexandria	Entity
bear	Concept
phonics	Concept
hunting	Concept
Phi Sigma Sigma	Entity
Figurines	Entity
Tang Xianzu	Entity
sphygmomanometer	Concept
hurt	Concept
heartburn	Concept
manufacturing	Concept
waybill	Concept
Lars Leksell	Entity
accelerator	Concept
jet stream	Concept
island	Concept
Winston S. Churchill	Entity
parents	Concept
wave	Concept
male	Concept
catchment area	Concept
dungeon	Concept
soil pipe	Concept
feudatory	Concept
ridge	Concept
sprain	Concept
human	Concept
arms	Concept
terminology	Concept
shogunate	Concept
landgrave	Concept
Jean Coralli	Entity
shooter	Concept
mountain	Concept
blastomere	Concept
Fredericksburg	Entity
AT&T	Entity
Larderello	Entity
XML	Entity
antagonism	Concept
Tropical Storm Cindy	Entity
nonage	Concept
spondee	Concept
register	Concept
patient	Concept
rebel	Concept
Reconnaissance Battalion	Entity
Ubu Roi	Entity
mask	Concept
torture	Concept
Denning	Entity
validity	Concept
La Veta Pass	Entity
midfield	Concept
Antony Leung	Entity
Swarthmore	Entity
mouse	Concept
aflatoxin	Concept
anapsid	Concept
Auguste Rodin	Entity
Jim Beach	Entity
Reckless Kelly	Entity
Sachs Harbour	Entity
website	Concept
children	Concept
laptop	Concept
relative humidity	Concept
bladder cancer	Concept
Under the Moon	Entity
Neil Gillman	Entity
PubMed	Entity
sapphire	Concept
habit	Concept
El Mercurio	Entity
psychopathology	Concept
switcher	Concept
Dunbar	Entity
True Grit	Entity
water balloon	Concept
Rell Sunn	Entity
route	Concept
rabble-rouser	Concept
Keats House	Entity
gdbserver	Concept
rosiness	Concept
magistrate	Concept
Lyon	Entity
clopidogrel bisulfate	Concept
colonial	Concept
fumigation	Concept
subspecies	Concept
hovel	Concept
flag	Concept
curling	Concept
topping	Concept
Hill cipher	Concept
Lancashire	Entity
William Corson	Entity
Ronas Hill	Entity
government	Concept
balsam	Concept
jammies	Concept
Nonesuch Records	Entity
relay	Concept
currency	Concept
dinky	Concept
recycling	Concept
Inland Revenue	Concept
dinner	Concept
Evgeny Kissin	Entity
pocketbook	Concept
interdict	Concept
spending	Concept
narcolepsy	Concept
plumbing fixtures	Concept
George Soros	Entity
hakim	Concept
whoredom	Concept
lava dome	Concept
North Carolina	Entity
Hugoton	Entity
Half-Life 2	Entity
bed rest	Concept
bondman	Concept
restrictiveness	Concept
Galeras	Entity
cyclicity	Concept
Nancy	Entity
zero	Concept
sonogram	Concept
consumption	Concept
aerofoil	Concept
OpenOffice.org	Entity
incorporation	Concept
chopper	Concept
bowsprit	Concept
avenue	Concept
gorget	Concept
steeper	Concept
Fast Company	Entity
font	Concept
Paul Lafargue	Entity
Test Site	Entity
health economics	Concept
slut	Concept
Jackie Mittoo	Entity
yardage	Concept
light	Concept
earl	Concept
hair	Concept
Cambridge	Entity
eisteddfod	Concept
Susanna Clarke	Entity
Joan Silber	Entity
Michael Owen	Entity
Ramesh Powar	Entity
Post	Entity
corporation	Concept
colostrum	Concept
belfry	Concept
instrumental	Concept
bridge	Concept
escheat	Concept
epistemology	Concept
wheeler	Concept
referee	Concept
philia	Concept
Olivia de Havilland	Entity
Howard K. Smith	Entity
foster-child	Concept
breakwater	Concept
software suite	Concept
telemovie	Concept
Photek	Entity
grass	Concept
penal colony	Concept
smuggler	Concept
need	Concept
space research	Concept
redundancy check	Concept
disk	Concept
status epilepticus	Concept
lyceum	Concept
Quebec	Entity
spelunker	Concept
chauvinism	Concept
warship	Concept
blind	Concept
gateway	Concept
Harold W. Dodds	Entity
academician	Concept
video	Concept
Old Oaken Bucket	Entity
magazine	Concept
journalism	Concept
Dominique Voynet	Entity
loser	Concept
jockey	Concept
roe	Concept
Narragansett Bay	Entity
chess	Concept
licentiate	Concept
documentary	Concept
softball	Concept
Tufts University	Entity
Griselda	Entity
sixpence	Concept
diffraction	Concept
This Love	Entity
John Livingston	Entity
cell death	Concept
adage	Concept
doldrums	Concept
Franck Goddio	Entity
Walter Gropius	Entity
monzonite	Concept
cribbage	Concept
elopement	Concept
intramuscular injection	Concept
observation	Concept
ergotamine	Concept
sial	Concept
Siegfried Sassoon	Entity
Fourth World	Entity
drinking	Concept
Game Boy Advance	Entity
wand	Concept
imperialism	Concept
learner	Concept
IRA	Concept
liquid nitrogen	Concept
Automatix	Entity
hydrosphere	Concept
Beatties	Entity
rockfish	Concept
north	Concept
emulator	Concept
customer	Concept
wetsuit	Concept
Knoxville	Entity
Allakhazam	Entity
The Mail	Entity
annual general meeting	Concept
power	Concept
halfpenny	Concept
Frankenstein	Entity
district court	Concept
nonreader	Concept
earphones	Concept
Maximum Carnage	Entity
newsagent	Concept
supermajority	Concept
boson	Concept
fund	Concept
John Franks	Entity
Seekonk	Entity
wine	Concept
cosmic dust	Concept
particle	Concept
tonne	Concept
carborundum	Concept
GTA	Entity
corpus delicti	Concept
piastre	Concept
chief research officer	Concept
foreign policy	Concept
Scott White	Entity
Iran-Iraq War	Entity
tapir	Concept
Mitchell Brown	Entity
sulfur dioxide	Concept
grad	Concept
violet	Concept
November	Entity
emblem	Concept
John Flamsteed	Entity
Huey Lewis	Entity
sigma	Concept
Bronze Horseman	Entity
Melk	Entity
prairie cordgrass	Concept
Catherine Morland	Entity
Jackson Zoo	Entity
Jesse Alexander	Entity
police	Concept
allies	Concept
decal	Concept
permanent magnet	Concept
quarry	Concept
Sam Browne	Entity
Hamilton Airport	Entity
stater	Concept
tricolour	Concept
classification	Concept
Pusey	Entity
price of admission	Concept
Altai Mountains	Entity
abhorrence	Concept
clipping	Concept
communization	Concept
workforce	Concept
belt	Concept
payoff	Concept
Kaweah River	Entity
great-grandfather	Concept
darkey	Concept
toll road	Concept
riel	Concept
par	Concept
senior status	Concept
racial profiling	Concept
microprocessor	Concept
The Race	Entity
stratum	Concept
decaf	Concept
axile placentation	Concept
fox	Concept
Mollie Katzen	Entity
real world	Concept
Bharata	Entity
insight	Concept
possession	Concept
precipitation	Concept
protist	Concept
aerodrome	Concept
Africa	Entity
preaching	Concept
palisade	Concept
vaporization	Concept
lustiness	Concept
compiler	Concept
adventure	Concept
award	Concept
notion	Concept
fertility rate	Concept
Sam Rainsy	Entity
transportation	Concept
warming	Concept
Malvolio	Entity
cell culture	Concept
Vera Nazarian	Entity
sou	Concept
Karl Friedrich Gauss	Entity
lava	Concept
golden rule	Concept
USS Shiloh	Entity
Cymru	Entity
overpass	Concept
religiosity	Concept
spokesman	Concept
doodlebug	Concept
Maximian	Entity
frequence	Concept
label	Concept
autonomous region	Concept
Harmonia axyridis	Concept
settlement	Concept
Cnidaria	Concept
open-source software development	Concept
oviduct	Concept
spam	Concept
paprika	Concept
pilot	Concept
smut	Concept
committee	Concept
Morris Carnovsky	Entity
wingspread	Concept
cumulus	Concept
Dalbergia melanoxylon	Concept
Himalaya	Entity
Carly Fiorina	Entity
Amelia Earhart	Entity
flyswatter	Concept
parkway	Concept
Jemison	Entity
jerkin	Concept
Tommy Gavin	Entity
waviness	Concept
syneresis	Concept
appearing	Concept
empire	Concept
housing	Concept
Martin State Airport	Entity
century	Concept
yaupon holly	Concept
Joyce	Entity
Howard Davis	Entity
Orlando Sentinel	Entity
club	Concept
shirt	Concept
Myrdal	Entity
counterclaim	Concept
Wang Xiaolong	Entity
cloister	Concept
Scott Styris	Entity
conspiracy	Concept
Kennedy	Entity
Chris Phillips	Entity
Modest Mouse	Entity
business software	Concept
lysine	Concept
hosiery	Concept
pointer	Concept
Czestochowa	Entity
comic	Concept
jug	Concept
subsidy	Concept
Rigveda	Entity
Lugh	Entity
Judd Gregg	Entity
Diocletian	Entity
hearsay rule	Concept
Omiya	Entity
animosity	Concept
street	Concept
leaf curl	Concept
meningitis	Concept
southwestward	Concept
excommunication	Concept
John Fitzgerald Kennedy	Entity
Turrican	Entity
shed	Concept
outfielder	Concept
Lutyens	Entity
serfdom	Concept
emerald	Concept
Isle of Arran	Entity
bottled water	Concept
outreach	Concept
viral marketing	Concept
pe	Concept
Grigori Perelman	Entity
Louisiana	Entity
check-in	Concept
road rage	Concept
Gene DeWeese	Entity
page	Concept
lost cause	Concept
Michael Costa	Entity
pollock	Concept
Poitiers	Entity
Richard Posner	Entity
vendue	Concept
great-grandmother	Concept
health facility	Concept
Venus	Entity
special forces	Concept
StarCraft	Entity
baker	Concept
Klaus Nomi	Entity
chaldron	Concept
militia	Concept
czar	Concept
petition	Concept
Be Yourself	Entity
pafuramidine	Concept
tactic	Concept
intermittent claudication	Concept
pontiff	Concept
interior decoration	Concept
fleur-de-lis	Concept
family therapy	Concept
distribution	Concept
John McPherson	Entity
regulating	Concept
autocracy	Concept
stake	Concept
Seema Biswas	Entity
employee	Concept
potassium iodide	Concept
apple pie	Concept
scabies	Concept
policy	Concept
DirectX	Entity
S4	Concept
Novi Vinodolski	Entity
Giovanni Bellini	Entity
smoke	Concept
Bealeton	Entity
Europe	Entity
FutureGen	Entity
orison	Concept
retirement benefit	Concept
Tulsa	Entity
Dave Littlefield	Entity
expiration date	Concept
blazonry	Concept
fuse	Concept
color	Concept
brain	Concept
lousiness	Concept
Vietnam	Entity
straw man	Concept
Wiktionary	Entity
faulting	Concept
skepticism	Concept
etymologizing	Concept
Robert Adams	Entity
Richard Barnes Mason	Entity
Half-Life	Entity
Mario Kart DS	Entity
Wellington Road	Entity
jerky	Concept
Deck	Concept
Irish	Entity
slump	Concept
disobedience	Concept
Lander University	Entity
New Jersey	Entity
tartar	Concept
Archaean	Entity
gusset	Concept
Matt Dean	Entity
Niels Bohr	Entity
attic	Concept
Kohler	Entity
botany	Concept
eudaimonia	Concept
Nyahururu	Entity
flocculation	Concept
money	Concept
Blithe Spirit	Entity
Lucrezia Borgia	Entity
Hamlet	Entity
couture	Concept
sheepshead	Concept
interception	Concept
Typhoon Lupit	Entity
Russell Shorto	Entity
Ohio	Entity
grandee	Concept
monoclonal	Concept
sodium nitrite	Concept
iota	Concept
yesterday	Concept
sacrifice	Concept
beam	Concept
Gary Fong	Entity
Azua	Entity
dealer	Concept
Durham	Entity
panorama	Concept
Epistles	Entity
bird sanctuary	Concept
index	Concept
Dorothea Puente	Entity
self-confidence	Concept
chapter	Concept
nail	Concept
Blindsight	Entity
judge	Concept
green olive	Concept
blackfly	Concept
Andronicus of Rhodes	Entity
unintelligibility	Concept
sugar-cane	Concept
Fahrenheit	Entity
Dublin Bus	Entity
leishmaniasis	Concept
BioCryst Pharmaceuticals	Entity
Tellico Reservoir	Entity
ancient philosophy	Concept
disservice	Concept
Wolfe	Entity
tahini	Concept
administrator	Concept
abnegation	Concept
Make the Grade	Entity
stonecutter	Concept
footway	Concept
thread	Concept
storm	Concept
Sigma Lambda Beta	Entity
Mary McCarthy	Entity
conviction	Concept
throw	Concept
outlaw	Concept
umber	Concept
liberalism	Concept
lobbyist	Concept
vicarious liability	Concept
spot price	Concept
precognition	Concept
POB	Concept
nutrient	Concept
gene	Concept
cooking ingredient	Concept
photograph	Concept
saprolite	Concept
Callender	Entity
seal	Concept
noun	Concept
declaration	Concept
Stan Lee	Entity
air mass	Concept
inherited disease	Concept
track	Concept
Zhao Ziyang	Entity
flooring	Concept
ammonium	Concept
