observatory	laboratory	workplace	locale	research center	center	institute
city	watercraft	manifold	merchant shipping	piece of land	vessel	ship	parcel of land	piece of ground
stimulus	mental image	image
corporation	company	partnership	person	venture	concern
picture	musical composition	moving picture	song	dance band	musical work	piece of music	show	pic	vocal	track	musical group	moving-picture show	movie	music group
manual labour	handling	job market	labour economics	labour market	employment market	manual labor	toil	labor market
person
natural process	human process	chemical process
physicist	person
killer	ending	judgement	confinement	final decision	killing	judgment	penalty	final judgment	death	cause of death	conviction	due process	penalisation	penalization	putting to death	state	punishment
work of art	pic	picture show	film	album	soundtrack	musical composition
coleopteran	insect	beetle	beetles
heavenly body	celestial body	astronomical object	planetoid
software program	software package	software	application	application software	computer program	software application
data
convex shape	calculation	figuring	dimensional analysis	peak	measure
actuality	state	fact
quaternary ammonium	quaternary ammonium compound
herb	herbaceous plant	plant
firm	corporation	company	partnership	concern
motion	sound	noise	shot	demo	discharge	move	blowup	outburst
dupe	confectionery	teleost fish	victim	marine animal	simple sugar	goody	confection	confectionary	candy	sugar	carbohydrate	sweets	methodology	treat	animal	sweet	pisces	sea animal
school text	investigation	methodology	textbook	method
branch of science	physics	research
shipper
emu	wild horse	subspecies	horse	equid
software development	product development	development
person	philosopher	psychologist	intellectual	scholar
difference	dispute	reasoning	difference of opinion	discussion
heavenly body	celestial body	astronomical object	star
social club
city
bookman	scholarly person	journalist	writer	literate	intellectual	scholar	activist	person	politician
economic sector	cultivation
brain	body part
file format	data format	software program	software package	coding system	software standard	free software	computer file	textfile	computer code	file	computer program	computer programme	software	computer software
drug
politician	member of parliament	advocate	negotiator	boss	person	chief	political leader	leader	legislator
person	juridical person	service	concern
energy
person
appendage	limb	shoe	footwear	extremity	body part
plant	aromatic plant	herb	herbaceous plant
code	time interval	interval	break	computer code	computer program	inactivity	pause	music notation	note	musical notation
extinct volcano	mountain	elevation	natural elevation	island	mount	terrain	dormant volcano	volcano
brain tumor	tumor	cancer	malady	illness	sickness	pathological state	disease	disorder	pathology
durable good	habitat	structural member	home ground	single-valued function	forrest	raw material	architectural element	biosystem	durable goods	surroundings	support	surround	microenvironment	environment	microhabitat	wood	forest	structural element	building material	scheme	durables
body substance	bodily fluid	biofluid	hormone	humor	biomolecule	biopolymer	chemical group	chemical series	signaling molecule	chemical bond	internal secretion	gi hormones	body fluid	gastrointestinal hormone	moiety	bond
town
bookman	intellectual
