episode
scholar	life scientist	intellectual	person	scholarly person	philosopher	student	biologist
convenience	suitability	suitableness
penalty	money	cost	expenditure
anthropologist	person
news story	piece of work
specifications	disease
certainty	certitude
protein	treat	macromolecule	membrane
primary color	spectral color	primary colour
person	student
internet site	electronic media	network	website
periodical	show	periodical literature	series	broadcast	mass medium	mass media	channel
disease	sickness
city
platform game	electronic game	video game	software program	software package	software	application	application software	computer program	software application
private school	school	educational institution
initiate	tiro	person
conservative
social action	computer software	software package	systems program	prompt	computer program	opening	software
bone	general anatomy	body structure	anatomical structure
bookman	scholar	scholarly person	historiographer	historian	intellectual	person
constructed structure	lexical unit	edifice	dictionary entry	public building	language unit	lexical item
town	fictional character	person
sound	phone	mechanism
atmosphere	windstorm	violent storm	air current	atmospheric state	density	current of air	storm damage	atmospheric phenomenon	storm	cyclone	natural phenomenon	tempest	wind
protein	biopolymer	supermolecule	macromolecule	biomolecule	polymer
foodstuff	food product
multinational	company	firm	enterprise	corporation	venture	juridical person
person	counsel	advocate	legal expert
workplace	apartment	flat	housing
music genre	musical style
person	coding system	software	application	application software	software application	software program	computer program
silverware	face	cup	recipient
stone	sandstone	rock	sedimentary rock
landmark	commune
measuring	moving picture	habit	judgement
set theory	definite quantity	accuracy	accuracy and precision	exactness
calculation	transmission channel	storage	rotating mechanism	electronic device	memory device
slot	electrical network	component	add-in	controller	plug-in	integrated circuit	constituent	card	circuit board	microcircuit	electric circuit	switch	board	circuit	circuit card
cell	thread of execution	fabric	thread	cloth	food product	hardware	equipment	foodstuff	textile	computer hardware
discrimination	racism	racial discrimination
public university	university	educational institution	academy
person
plant	green goods	pear	edible fruit	woody plant	flowering tree	pear tree
city	military action	violence	fight	pitched battle	warring	battle	armed combat	war
source text	periodical publication	communication medium
intelligence service	intelligence	intelligence agency	government agency
tending	group therapy	medical aid	health care	therapy	treatment	aid	care	intervention
point of reference	interpretation	rendering	interpreting	rendition	constituent
