plainchant	Concept
adult contemporary	Concept
traditional folk	Concept
motif	Concept
americana	Concept
psychedelic rock	Concept
Just Dance	Entity
Loaded	Entity
dithyramb	Concept
Johnny Cash	Entity
panpipes	Concept
soft rock	Concept
Louis Armstrong	Entity
lament	Concept
Stereolab	Entity
oboe	Concept
bluegrass	Concept
Bob Dylan	Entity
roots rock	Concept
score	Concept
concertos	Concept
Pakistani rock	Concept
misquote	Concept
drum set	Concept
alternative metal	Concept
saxophone	Concept
rock-and-roll	Concept
Electric guitar	Concept
Fleetwood Mac	Entity
Stream of Consciousness	Entity
Christian rock	Concept
bass guitar	Concept
The Clash	Entity
g√ºiro	Concept
partita	Concept
Artwork	Entity
outlaw country	Concept
bell lyre	Concept
rhythm and blues	Concept
Paul McCartney	Entity
Latin jazz	Concept
marching music	Concept
David Bowie	Entity
operetta	Concept
rocksteady	Concept
Aphex Twin	Entity
impromptu	Concept
singalong	Concept
religious song	Concept
postlude	Concept
brazilian jazz	Concept
guitar gods	Concept
Bruce Springsteen	Entity
minuets	Concept
fanfare	Concept
motown	Concept
bagpipe	Concept
flugelhorn	Concept
drum kit	Concept
antiphon	Concept
Lose My Breath	Entity
Coil	Entity
Agoraphobia	Entity
opera	Concept
ratchet	Concept
electric blues	Concept
slapstick	Concept
bongo drum	Concept
barcarolle	Concept
cowboy	Concept
horn	Concept
solfeggio	Concept
excerpt	Concept
shanty	Concept
serious music	Concept
Never Say Die	Entity
alto clarinet	Concept
alphorn	Concept
folk rock	Concept
urban folk	Concept
Let It Be	Entity
David Foster	Entity
baritone horn	Concept
Summertime	Entity
christmas	Concept
Bounce	Entity
motive	Concept
quote	Concept
The Clovers	Entity
Beastie Boys	Entity
inversion	Concept
sextet	Concept
Nightwish	Entity
track	Concept
psalmody	Concept
voices	Concept
arena rock	Concept
pastorale	Concept
preludes	Concept
intro	Concept
death metal	Concept
Someday Came Suddenly	Entity
musical composition	Concept
humming	Concept
dulcimer	Concept
Citysong	Entity
musical harmony	Concept
morceau	Concept
Handbags and Gladrags	Entity
lullabies	Concept
christmas carol	Concept
polka	Concept
piano	Concept
organ	Concept
sheng	Concept
melodic theme	Concept
scottish folk	Concept
duranguense	Concept
british punk	Concept
mariachi	Concept
singing	Concept
xylophone	Concept
Pete Yorn	Entity
viola	Concept
rebec	Concept
musical passage	Concept
canons	Concept
Velvet Monkeys	Entity
Live Forever	Entity
ukelele	Concept
adult alternative	Concept
lullaby	Concept
The Crusade	Entity
euphonium	Concept
washboard	Concept
Elvis Presley	Entity
grate	Concept
Sex Pistols	Entity
piece	Concept
baritone guitar	Concept
surf rock	Concept
Elton John	Entity
Ira D. Sankey	Entity
andante	Concept
military march	Concept
music box	Concept
salsa	Concept
serenade	Concept
caroling	Concept
The Rolling Stones	Entity
oldies	Concept
trio	Concept
Black Sabbath	Entity
sleigh bells	Concept
Avalon	Entity
cello	Concept
The Magic Flute	Entity
chimes	Concept
train whistle	Concept
rock	Concept
Up All Night	Entity
soul	Concept
The Cure	Entity
cool jazz	Concept
paean	Concept
techno	Concept
ballet	Concept
lieder	Concept
progressive rock	Concept
Whip My Hair	Entity
crash cymbals	Concept
accordion	Concept
Antichrist Superstar	Entity
solo	Concept
bass clarinet	Concept
tenor	Concept
antiphonal	Concept
Gittler guitar	Concept
finger cymbals	Concept
Duke Ellington	Entity
bass part	Concept
anthem	Concept
harmonium	Concept
korean pop	Concept
cover song	Concept
Lollipops and Roses	Entity
tambourine	Concept
recorder	Concept
medley	Concept
symphony	Concept
lo-fi	Concept
dream pop	Concept
habanera	Concept
Nightshift	Entity
crumhorn	Concept
tributes	Concept
X Japan	Entity
drums	Concept
symphonic poem	Concept
blues	Concept
John Peel	Entity
gavotte	Concept
acid jazz	Concept
drumstick	Concept
bongos	Concept
The Shins	Entity
modern blues	Concept
Ilosaarirock	Entity
shoegazing	Concept
traditional	Concept
rap	Concept
tubular bells	Concept
scat singing	Concept
electronic pop	Concept
quintette	Concept
Carl Davis	Entity
Your Favorite Weapon	Entity
chicago blues	Concept
phrase	Concept
accompaniment	Concept
punk	Concept
Goldfrapp	Entity
krautrock	Concept
spoken word	Concept
american punk	Concept
hornpipe	Concept
psytrance	Concept
twelve-tone system	Concept
operettas	Concept
transverse flute	Concept
Rockfest	Entity
hip-hop	Concept
new age	Concept
Quincy Jones	Entity
trad	Concept
jive	Concept
soundtrack album	Concept
oratorio	Concept
Taiwanese pop	Concept
mallet	Concept
chanting	Concept
Wagner	Entity
The Arrival	Entity
Public Enemy	Entity
schottische	Concept
Eminem	Entity
coloratura	Concept
strain	Concept
Origin	Entity
cadenza	Concept
Mute Print	Entity
instrumental music	Concept
folk songs	Concept
electronic	Concept
contrabass clarinet	Concept
My My	Entity
Eurythmics	Entity
celesta	Concept
zydeco	Concept
section	Concept
bass saxophone	Concept
variation	Concept
scherzo	Concept
baritone saxophone	Concept
rock'n'roll	Concept
Donkey	Entity
Sky Blue Sky	Entity
clipping	Concept
jump blues	Concept
Shamrock Diaries	Entity
introit	Concept
polonaise	Concept
snare drum	Concept
dixieland	Concept
Zeraphine	Entity
study	Concept
Frank Zappa	Entity
djembe	Concept
intonation	Concept
piano music	Concept
soprano saxophone	Concept
kwela	Concept
Latin hip-hop	Concept
Peter Gabriel	Entity
italian pop	Concept
Hot Mess	Entity
Indorock	Entity
septet	Concept
dance music	Concept
duet	Concept
ambient pop	Concept
Mackey Feary	Entity
Baker Street	Entity
teen pop	Concept
Hawkwind	Entity
short form	Concept
goth	Concept
polyphony	Concept
chamber pop	Concept
garage punk	Concept
bop	Concept
Benny Goodman	Entity
vibraphone	Concept
Cypress Hill	Entity
southern soul	Concept
bebop	Concept
jazz fusion	Concept
Fallen	Entity
Charlotte Church	Entity
Strauss	Entity
contemporary big band	Concept
obbligato	Concept
crwth	Concept
northern	Concept
vamp	Concept
Pavarotti	Entity
kithara	Concept
drumming	Concept
salutation	Concept
folk music	Concept
indie rock	Concept
Planningtorock	Entity
disco music	Concept
gregorian chant	Concept
Chamberlin	Entity
antique cymbals	Concept
Ascendancy	Entity
Dave Brockie	Entity
Dance Revolution	Entity
Silverthorn	Entity
hillbilly music	Concept
Lithuanian rock	Concept
etudes	Concept
Nevermind	Entity
composition	Concept
Hockey	Entity
arias	Concept
Ramones	Entity
musical drama	Concept
orchestra	Concept
recital	Concept
Tom Waits	Entity
instrumental	Concept
idyll	Concept
violin	Concept
chant	Concept
Megadeth	Entity
folksong	Concept
alto saxophone	Concept
new wave	Concept
west coast blues	Concept
The Donkeys	Entity
preamble	Concept
Telegraph Road	Entity
Heartland rock	Concept
The Beyond	Entity
march	Concept
Irma	Entity
vocal blues	Concept
vocal pop	Concept
pedal	Concept
carol	Concept
timbales	Concept
The Doldrums	Entity
fado	Concept
pan flute	Concept
trombone	Concept
Thornography	Entity
Hell Is	Entity
Metallica	Entity
bachata	Concept
Elvis Costello	Entity
zither	Concept
whistling	Concept
The War	Entity
rhumba	Concept
Unity Band	Entity
opening	Concept
swing	Concept
vallenato	Concept
shred	Concept
fiddle	Concept
western swing	Concept
Third Stage	Entity
comedic music	Concept
trumpet	Concept
pastoral	Concept
duo	Concept
Alison Goldfrapp	Entity
cutting	Concept
songbook	Concept
Marbles	Entity
quartette	Concept
steel drums	Concept
stride piano	Concept
quickstep	Concept
musical	Concept
Neil Young	Entity
folk ballad	Concept
doo-wop	Concept
negro spiritual	Concept
Katy Perry	Entity
euro pop	Concept
mouth organ	Concept
threnody	Concept
singer-songwriter	Concept
capriccio	Concept
character piece	Concept
figured bass	Concept
love-song	Concept
shawm	Concept
tenor saxophone	Concept
variations	Concept
Krush	Entity
Depeche Mode	Entity
irish folk	Concept
Dream Theater	Entity
Russian guitar	Concept
transition	Concept
motet	Concept
gigue	Concept
grand opera	Concept
a cappella singing	Concept
religious music	Concept
tom-tom	Concept
Seraphim	Entity
Miles Davis	Entity
classical music	Concept
solfege	Concept
passage	Concept
bagatelle	Concept
trio sonata	Concept
support	Concept
monody	Concept
French rock	Concept
britpop	Concept
Lollipop	Entity
r and b	Concept
serial music	Concept
maracas	Concept
Rancid	Entity
musette	Concept
AC/DC	Entity
movement	Concept
monophony	Concept
King Crimson	Entity
vocal jazz	Concept
orchestration	Concept
waltzes	Concept
Fursaxa	Entity
piano blues	Concept
cornet	Concept
Roar	Entity
gramophone	Concept
Welcome the Night	Entity
ostinato	Concept
texas blues	Concept
The Velvet Underground	Entity
Space Monkeys	Entity
samba	Concept
baton	Concept
Kazimierz Serocki	Entity
musical arrangement	Concept
latin pop	Concept
sonata	Concept
jamaican ska	Concept
kick drum	Concept
big beat	Concept
Shadows Fall	Entity
Rolling Stones	Entity
New Order	Entity
Jim O'Rourke	Entity
bongo drums	Concept
Liz Phair	Entity
improvisation	Concept
karaoke	Concept
old-time country	Concept
chansons	Concept
Kenny Hickey	Entity
ballroom music	Concept
garage rock	Concept
proto punk	Concept
Renaissance music	Concept
Photograph	Entity
keyboardist	Concept
funk rock	Concept
popular music	Concept
rondeau	Concept
harmonica blues	Concept
flamenco	Concept
kickdrum	Concept
Hot Issue	Entity
euphony	Concept
keyed trumpet	Concept
Back on Track	Entity
musical phrase	Concept
Wrapped Around	Entity
dub	Concept
percussion	Concept
piano sonata	Concept
