Sphagnum	Concept
Amsterdam Internet Exchange	Entity
heaven	Concept
hearsay rule	Concept
Chromosome 9	Entity
nuclear medicine	Concept
shell	Concept
transport	Concept
diffraction	Concept
Amis	Concept
intramuscular injection	Concept
Parveen Babi	Entity
cyclic guanosine monophosphate	Concept
literary critic	Concept
Ryan Hall	Entity
journalism	Concept
horsehair	Concept
plumbing fixtures	Concept
flipper	Concept
invalid	Concept
Knowth	Entity
guard	Concept
hedonism	Concept
syzygy	Concept
crusade	Concept
debenture	Concept
eschaton	Concept
color constancy	Concept
forum	Concept
full-duplex	Concept
brewing	Concept
Helene Deutsch	Entity
brute	Concept
Before Dark	Entity
risotto	Concept
cistron	Concept
Bowhead whale	Concept
workplace	Concept
decaf	Concept
bioenergy	Concept
glottal stop	Concept
Harold Volkmer	Entity
WITI	Entity
Otto von Habsburg	Entity
toll road	Concept
Bernard Laporte	Entity
domain	Concept
one-way street	Concept
aileron	Concept
market value	Concept
Sergei Shamba	Entity
waviness	Concept
Save Mart Center	Entity
maple leaf	Concept
metritis	Concept
philia	Concept
azathioprine	Concept
authentication	Concept
Woolsack	Entity
ethanol	Concept
GuideStar	Entity
Malta	Entity
writer	Concept
Meat Puppets	Entity
Narragansett Bay	Entity
saltire	Concept
honesty	Concept
pasqueflower	Concept
Reckless Kelly	Entity
steenbok	Concept
Mohave Community College	Entity
pastry cook	Concept
Saqqaq	Entity
alb	Concept
quads	Concept
inertia	Concept
terawatt	Concept
electron microscopy	Concept
corporation	Concept
Hurricane Wilma	Entity
gluon	Concept
Klaus Nomi	Entity
Gram Parsons	Entity
South East Wales	Entity
engram	Concept
subtropics	Concept
cancer	Concept
spare	Concept
pill	Concept
Czestochowa	Entity
Dave Littlefield	Entity
flag	Concept
recycling	Concept
Adam Crosthwaite	Entity
platform	Concept
Mario Kart DS	Entity
perpendicular	Concept
pin money	Concept
adobe	Concept
spectroscope	Concept
Pacaya	Entity
palomino	Concept
warrantor	Concept
Jeff Francis	Entity
William Jordan	Entity
palette	Concept
Ilex cassine	Concept
Theodore Roethke	Entity
exercise	Concept
Vernon Jarrett	Entity
dragonfly	Concept
triple	Concept
veratrum	Concept
Dhiren Barot	Entity
calmodulin	Concept
shelter	Concept
Voyager 1	Entity
Tony Malaby	Entity
complicatedness	Concept
religionism	Concept
Syria	Entity
Gabriel Guerra	Entity
moderator	Concept
grand	Concept
fumigation	Concept
putter	Concept
trailing	Concept
certificate	Concept
Battersea Arts Centre	Entity
foreshadowing	Concept
nonverbal communication	Concept
navigator	Concept
baker	Concept
bibliographic database	Concept
nutrition	Concept
Karl Sax	Entity
open-source software development	Concept
keyboardist	Concept
response	Concept
tebuconazole	Concept
economic growth	Concept
mail	Concept
Andrew Anderson	Entity
animation	Concept
precision	Concept
Harold W. Dodds	Entity
Huey Lewis	Entity
chronic	Concept
eversion	Concept
plantation	Concept
environmental psychology	Concept
day	Concept
twinjet	Concept
Carlo Levi	Entity
washing	Concept
Brady Smith	Entity
bend	Concept
aldicarb	Concept
beacon	Concept
Bomberman	Entity
Sandy Mitchell	Entity
Valetta	Entity
Valjean	Entity
ghrelin	Concept
Z1	Entity
running	Concept
Hannibal	Entity
oligoastrocytoma	Concept
duke	Concept
adage	Concept
cell culture	Concept
small cap	Concept
inquisitor	Concept
mercer	Concept
mug	Concept
rubbing alcohol	Concept
boundary	Concept
shepherd	Concept
OpenOffice.org	Entity
potter	Concept
blackface	Concept
conviction	Concept
glen	Concept
airport	Concept
skeet shooting	Concept
earthquake	Concept
RTLinux	Entity
farm animal	Concept
marketing research	Concept
arms	Concept
Mjolnir	Entity
Macklin	Entity
Deep learning	Concept
proposal	Concept
Kazak	Concept
hyperlink	Concept
in-joke	Concept
designation	Concept
aridity	Concept
ultranationalism	Concept
paragonite	Concept
Samuel Johnson	Entity
battle of Plataea	Entity
playwriting	Concept
Deutschland	Entity
Giovanni Bellini	Entity
cocktail	Concept
Monaco	Entity
exponent	Concept
hunting	Concept
newsprint	Concept
logotype	Concept
quinine	Concept
cellulose	Concept
successor	Concept
sedative	Concept
dam	Concept
Taco Cabana	Entity
proton pump	Concept
issuer	Concept
intermittent claudication	Concept
larder	Concept
Gurf Morlix	Entity
I-20	Entity
basin	Concept
availability	Concept
wine	Concept
backstay	Concept
round	Concept
ecology	Concept
convert	Concept
search engine	Concept
consumption	Concept
snag	Concept
Maryland	Entity
continuum	Concept
nutrient	Concept
insignia	Concept
Aryabhata	Entity
termination	Concept
tortilla chip	Concept
archduke	Concept
Fuzion Frenzy 2	Entity
Magnificent Mile	Entity
Delta Theta Phi	Entity
collage	Concept
anglophile	Concept
tectonics	Concept
European Parliament	Entity
W. Browning	Entity
dance	Concept
slugger	Concept
University of Liverpool	Entity
interior decoration	Concept
Urbana University	Entity
lion	Concept
Jon Clardy	Entity
TV	Concept
Visalia	Entity
pragmatism	Concept
workingman	Concept
Willow Street	Entity
Aramaic	Entity
pafuramidine	Concept
secular	Concept
cingulate gyrus	Concept
Los Angeles	Entity
smew	Concept
Sigrid Nunez	Entity
Sathyan	Entity
penis bone	Concept
Straight River	Entity
nu metal	Concept
Cymru	Entity
font	Concept
endarteritis	Concept
radical feminism	Concept
hovel	Concept
line of duty	Concept
sanctuary	Concept
Michael Castleman	Entity
general assembly	Concept
Neumont University	Entity
compound	Concept
jackhammer	Concept
fresco	Concept
DC	Concept
wetsuit	Concept
Ohio	Entity
endocarditis	Concept
debt	Concept
Monster Magnet	Entity
nitrification	Concept
fine	Concept
lobbyist	Concept
Mossbank	Entity
notebook computer	Concept
mugwump	Concept
Robert Boyle	Entity
shoulder	Concept
mask	Concept
restrictiveness	Concept
terrorism	Concept
Hamilton Airport	Entity
horse	Concept
habit	Concept
citizen	Concept
net	Concept
downlight	Concept
paprika	Concept
liquid nitrogen	Concept
grits	Concept
rejection	Concept
persecution	Concept
watercraft	Concept
parameter	Concept
elimination	Concept
nonreader	Concept
powertrain	Concept
prepositional phrase	Concept
shopping	Concept
subject	Concept
allies	Concept
newsagent	Concept
Saadia Gaon	Entity
Adobe Flash Lite	Entity
nonsmoker	Concept
dungeon	Concept
supervision	Concept
logical thinking	Concept
wing	Concept
episode	Concept
unintelligibility	Concept
slut	Concept
blindfold	Concept
hauling	Concept
belfry	Concept
Tommy Gavin	Entity
Africa	Entity
Knoxville	Entity
transportation	Concept
perdition	Concept
Slowhand	Entity
City of Whitehorse	Entity
Union Station	Entity
LEGO	Entity
shock	Concept
Tellico Reservoir	Entity
government	Concept
New Orleans	Entity
modeling	Concept
spell	Concept
RELCOM	Entity
sport	Concept
taxi	Concept
Pinot blanc	Concept
Tonto Creek	Entity
binge	Concept
Brassica napus	Concept
tableware	Concept
State Highway 12	Entity
Caligula	Entity
New Zealand	Entity
witch-hunt	Concept
grounds	Concept
Sam Crawford	Entity
lava dome	Concept
seal	Concept
dormouse	Concept
bayan	Concept
Lachaise	Entity
chateau	Concept
reporter	Concept
parkway	Concept
tax haven	Concept
macedonia	Concept
Burnaby	Entity
comic	Concept
Eilean Donan	Entity
Apiaceae	Concept
arm	Concept
Simon Walker	Entity
transmission	Concept
killer	Concept
Malmo	Entity
Marienkirche	Entity
spinal fusion	Concept
Boulder Creek	Entity
fire service	Concept
Louisville	Entity
disservice	Concept
Stardock	Entity
Cherie Nowlan	Entity
breakwater	Concept
President Lyndon Johnson	Entity
Bell	Entity
monoclonal	Concept
John Munroe	Entity
distributer	Concept
minute	Concept
Tropical Storm Alpha	Entity
human rights	Concept
Ronald Bunting	Entity
hurdling	Concept
galoshes	Concept
White House	Entity
ringtone	Concept
Ukraine	Entity
dejection	Concept
lie detector	Concept
gerontocracy	Concept
UN	Entity
Hurrican	Entity
American Stock Exchange	Entity
Supersonics	Entity
priority	Concept
strappado	Concept
delay	Concept
particle physics	Concept
committee	Concept
John Flamsteed	Entity
breve	Concept
econometrics	Concept
Antichrist	Entity
demonstration	Concept
Fourth World	Entity
Laksar	Entity
attempt	Concept
blunder	Concept
letter	Concept
accolade	Concept
senior	Concept
disengagement	Concept
disincentive	Concept
hooded cloak	Concept
rheumatism	Concept
gatekeeper	Concept
Konstantin Tsiolkovsky	Entity
retrieval	Concept
wire	Concept
streptomycin	Concept
overflow	Concept
Anna Lindh	Entity
smut	Concept
phone call	Concept
Leon Battista Alberti	Entity
minister	Concept
Keshu	Entity
assertion	Concept
fish	Concept
Hannity	Entity
parliament	Concept
sand verbena	Concept
patrician	Concept
counterpane	Concept
manslaughter	Concept
instrumental	Concept
Nancy	Entity
Roger Fry	Entity
Jerry Oltion	Entity
Paul Philippe Cret	Entity
Liege	Entity
rep	Concept
packet filtering	Concept
couture	Concept
accounting	Concept
papillon	Concept
Red Planet	Entity
Sonora	Entity
jockey	Concept
XML	Entity
Federal Records	Entity
rowlock	Concept
Jurmo	Entity
argument	Concept
immateriality	Concept
biology	Concept
Turrican	Entity
flare	Concept
Dara Horn	Entity
wicketkeeper	Concept
stonecutter	Concept
outfit	Concept
Gunther Gebel-Williams	Entity
rabidity	Concept
alumnus	Concept
pilot	Concept
Exodus	Entity
S4	Concept
vibe	Concept
AltiVec	Entity
district court	Concept
Plovdiv	Entity
grenadilla	Concept
Young	Entity
singlet	Concept
working capital	Concept
Bryher	Entity
weapon	Concept
confederacy	Concept
woofer	Concept
turquoise	Concept
tax	Concept
Olivia de Havilland	Entity
festivity	Concept
suspension	Concept
soaker	Concept
affectionateness	Concept
Beatrice	Entity
pragmatics	Concept
Secant	Concept
Devonian	Entity
test	Concept
sort	Concept
Bill Clinton	Entity
Bharata	Entity
religiosity	Concept
Springboro	Entity
Tim Dwight	Entity
purslane	Concept
expedition	Concept
handshake	Concept
thunder	Concept
owner	Concept
nag	Concept
subsoil	Concept
cosmic dust	Concept
Haven	Entity
confederation	Concept
diffusor	Concept
Cyclone Gafilo	Entity
Local Group	Entity
disposition	Concept
angular momentum	Concept
finalization	Concept
Port Huron	Entity
bothy	Concept
East Capitol Street	Entity
coder	Concept
Battlestar Galactica	Entity
powerhouse	Concept
employee	Concept
gypsum	Concept
sub-interval	Concept
microprocessor	Concept
Emmeline Pankhurst	Entity
world	Concept
bigtooth aspen	Concept
Valley Girls	Entity
savoy	Concept
lordship	Concept
community	Concept
Gagandeep Singh	Entity
Bill Pullman	Entity
Hotel Europe	Entity
collector	Concept
junkware	Concept
Castlereagh River	Entity
Joseph Rodman Drake	Entity
laurel	Concept
Dorothy Richardson	Entity
Hurricane Claudette	Entity
samurai	Concept
rap music	Concept
spokesman	Concept
IBM 1620	Entity
Fahrenheit	Entity
groceries	Concept
grass	Concept
quake	Concept
proof	Concept
El Mercurio	Entity
theme	Concept
Richard Rathbun	Entity
immunologist	Concept
yaupon holly	Concept
herb tea	Concept
Diocletian	Entity
Hadrian	Entity
Margaret Robinson	Entity
tomato soup	Concept
Hurricane Epsilon	Entity
Matthew Murphy	Entity
summit	Concept
AI	Concept
ladino	Concept
blueness	Concept
Tharsis	Entity
epistemology	Concept
index	Concept
Old Oaken Bucket	Entity
cyclicity	Concept
mould	Concept
price reduction	Concept
Morris Carnovsky	Entity
counterclaim	Concept
St. Edward	Entity
skepticism	Concept
economic policy	Concept
miscarriage of justice	Concept
dwarf planet	Concept
chairman	Concept
hometown	Concept
cusp	Concept
pipe	Concept
Tarleton	Entity
antagonism	Concept
vice president	Concept
carbon dioxide	Concept
Brasilia	Entity
brutalisation	Concept
Novi Vinodolski	Entity
Cortes	Entity
magistrate	Concept
Lutyens	Entity
short-term memory	Concept
airlock	Concept
marine	Concept
mark	Concept
ossification	Concept
Dennis Lillee	Entity
fence	Concept
ground	Concept
Hurricane Iniki	Entity
stymy	Concept
Richard Posner	Entity
outreach	Concept
chaldron	Concept
covenant	Concept
lava	Concept
height	Concept
misfire	Concept
slop	Concept
ghee	Concept
delicacy	Concept
bolster	Concept
Anna Magnani	Entity
prexy	Concept
hacker	Concept
Under the Moon	Entity
turn	Concept
payoff	Concept
milkwort	Concept
Herodian	Entity
baguette	Concept
Herman Melville	Entity
wrestle	Concept
striatum	Concept
Earthsea	Entity
white water	Concept
Orlando Sentinel	Entity
administrator	Concept
whoredom	Concept
charity	Concept
history of science	Concept
door	Concept
Michael Costa	Entity
expiration date	Concept
Martinair	Entity
Johan Remkes	Entity
bastinado	Concept
imperialism	Concept
Tony Trujillo	Entity
wand	Concept
eponychium	Concept
metadata	Concept
vulcanite	Concept
fellah	Concept
haulier	Concept
surf	Concept
space	Concept
grandee	Concept
oxalic acid	Concept
phonics	Concept
drug of abuse	Concept
barley	Concept
hosiery	Concept
buckle	Concept
disc	Concept
bar	Concept
teleportation	Concept
course	Concept
Catholic	Concept
David Gustafson	Entity
sixpence	Concept
Manarola	Entity
Arapaho	Entity
fire	Concept
Jack Trout	Entity
incandescence	Concept
waxwork	Concept
radio	Concept
defeat	Concept
placebo effect	Concept
decomposition	Concept
desiccation	Concept
Phrygian cap	Concept
sacrifice	Concept
abdication	Concept
D'Arcy Wentworth	Entity
Hurricane Rita	Entity
Coliseum	Entity
maharaja	Concept
contrast agent	Concept
form	Concept
computational model	Concept
smoke	Concept
ounce	Concept
Paul Lafargue	Entity
psychopathology	Concept
telecommunications	Concept
sneeze	Concept
restaurant	Concept
infrastructure	Concept
transit	Concept
Tau Kappa Epsilon	Entity
stomach	Concept
Meanjin	Entity
Transportation	Entity
sidestroke	Concept
Cocina	Entity
Zelda	Entity
tenement	Concept
blackfly	Concept
Verrier Elwin	Entity
Shoot the Dog	Entity
sou	Concept
Touch and Go	Entity
biosatellite	Concept
owner-occupier	Concept
blind	Concept
tahini	Concept
advancement	Concept
lynching	Concept
tussle	Concept
Vilfredo Pareto	Entity
Laurel Touby	Entity
Hurricane Dennis	Entity
MXML	Entity
grave	Concept
rosiness	Concept
Ronas Hill	Entity
Elbridge Gerry	Entity
beef	Concept
liquidation	Concept
Finding Forrester	Entity
stationmaster	Concept
Susannah York	Entity
medical care	Concept
bere	Concept
rat-catcher	Concept
pervert	Concept
law	Concept
classification	Concept
quoit	Concept
Post	Entity
sovereign	Concept
Burger King	Entity
public service	Concept
petty officer	Concept
Quercus ilex	Concept
Maginot	Entity
French	Entity
fading	Concept
Zhao Ziyang	Entity
human migration	Concept
frequence	Concept
cap	Concept
Melk	Entity
Younger Dryas	Entity
timber	Concept
snatch	Concept
organdy	Concept
Swing music	Concept
sloop	Concept
lift	Concept
white coat	Concept
Wild Kingdom	Entity
suffragette	Concept
village hall	Concept
viceroy	Concept
Typhoon Muifa	Entity
baptismal font	Concept
baronet	Concept
whiteness	Concept
German mark	Concept
Modest Mouse	Entity
HMAS Perth	Entity
reactionary	Concept
regeneration	Concept
horsepower	Concept
wage	Concept
Serpens	Entity
lysine	Concept
preserve	Concept
streptomyces	Concept
relative price	Concept
teamster	Concept
giro	Concept
Kralendijk	Entity
babysitting	Concept
Minnamurra	Entity
jeopardy	Concept
space research	Concept
BattleTech	Entity
character	Concept
nuclear war	Concept
Erika Nordby	Entity
questionnaire	Concept
weather forecasting	Concept
links	Concept
arbitrage	Concept
frogmouth	Concept
recall	Concept
Circle Jerks	Entity
Thanatos	Entity
differential	Concept
hypostasis	Concept
retirement benefit	Concept
Walter Gropius	Entity
commodity	Concept
A1 motorway	Entity
anticlimax	Concept
fifty	Concept
web	Concept
dividend	Concept
arboriculture	Concept
referee	Concept
Swami Haridas	Entity
hair	Concept
bulk	Concept
Michael Nielsen	Entity
hybrid	Concept
triumvirate	Concept
sailing ship	Concept
tactic	Concept
neurohypophysis	Concept
belt	Concept
Busta Rhymes	Entity
leaf curl	Concept
Michael Owen	Entity
personal check	Concept
defiance	Concept
specialist	Concept
Mark Tully	Entity
TimeShift	Entity
screen	Concept
licentiate	Concept
Fredericksburg	Entity
Belfast Lough	Entity
Oakland City Hall	Entity
journal	Concept
headquarters	Concept
register	Concept
attorney	Concept
Bill Koski	Entity
label	Concept
Deputy	Concept
Anthony Caro	Entity
greensand	Concept
lemon verbena	Concept
posey	Concept
clerid	Concept
hero	Concept
pellicle	Concept
BioCryst Pharmaceuticals	Entity
serial	Concept
hurt	Concept
cell death	Concept
quincunx	Concept
management	Concept
supernaturalism	Concept
Leipzig	Entity
radish	Concept
plume	Concept
equitation	Concept
commoner	Concept
ruby	Concept
rubble	Concept
oriflamme	Concept
Amoy	Concept
Bierstadt	Entity
tension	Concept
trade	Concept
need	Concept
Tacitus	Entity
proprioception	Concept
violin	Concept
Nuptse	Entity
mill	Concept
sun	Entity
beer	Concept
program	Concept
derby	Concept
Surdas	Entity
unification	Concept
netherworld	Concept
ecclesiastic	Concept
Crowds and Power	Entity
marriage	Concept
afterlife	Concept
Grani	Entity
lost cause	Concept
shoal	Concept
heritage	Concept
track	Concept
field hospital	Concept
center	Concept
rabble-rouser	Concept
Bingley	Entity
Gary Fong	Entity
parceling	Concept
negritude	Concept
porphyrin	Concept
Rockwell Kent	Entity
troll	Concept
share	Concept
handful	Concept
boson	Concept
storehouse	Concept
Raoul Dufy	Entity
window	Concept
landgrave	Concept
tau neutrino	Concept
Cyrus K. Holliday	Entity
turnpike	Concept
Nathan Lane	Entity
incorporation	Concept
glycogen synthase	Concept
sarcophagus	Concept
coda	Concept
joystick	Concept
granularity	Concept
Mae West	Entity
isolationism	Concept
thread	Concept
language	Concept
Brookline	Entity
glutton	Concept
business concern	Concept
Swansea	Entity
dexterity	Concept
stucco	Concept
boar	Concept
scoutmaster	Concept
The Mail	Entity
activator	Concept
St. Bernard Software	Entity
script	Concept
perfidiousness	Concept
John Romer	Entity
highschool	Concept
hustler	Concept
caldera	Concept
Pure Pinball	Entity
Manage	Entity
yawl	Concept
British Home Stores	Entity
success	Concept
cornstarch	Concept
Winsor School	Entity
tropical depression	Concept
nationalization	Concept
Saint Anna	Entity
reading teacher	Concept
club	Concept
redundancy check	Concept
Slax	Entity
Eric Becklin	Entity
shortsightedness	Concept
damages	Concept
overhead	Concept
madam	Concept
agogo	Concept
Scleranthus	Concept
Mayon Volcano	Entity
decentralisation	Concept
sweetness	Concept
World War II	Entity
conscience	Concept
plasma	Concept
spile	Concept
Mel Gibson	Entity
parking	Concept
harvesting	Concept
extropy	Concept
conditionality	Concept
Jackson Zoo	Entity
neurologist	Concept
Skara Brae	Entity
Erna Brodber	Entity
L.A. Confidential	Entity
terrier	Concept
Charles Alexander	Entity
residence time	Concept
playlist	Concept
air mass	Concept
judge	Concept
amaretto	Concept
writing	Concept
diadem	Concept
pane	Concept
envelopment	Concept
Paynes Creek	Entity
cascade	Concept
relief	Concept
Russell Shorto	Entity
John McPherson	Entity
tapir	Concept
cumulus	Concept
Jesse Alexander	Entity
Wernher von Braun	Entity
royalist	Concept
agitation	Concept
bachelor	Concept
Nohar	Entity
Kaweah River	Entity
emptiness	Concept
Manassas	Entity
Winterthur	Entity
carting	Concept
quietness	Concept
gelatin	Concept
viola	Concept
liquid	Concept
word	Concept
St. Augustine	Entity
resonance	Concept
David T. Ellwood	Entity
Korea	Entity
enlistment	Concept
far left	Concept
Sidney R. Yates	Entity
gradation	Concept
architecture	Concept
selector	Concept
learner	Concept
local government	Concept
placoderm	Concept
male	Concept
shawl	Concept
Roos	Entity
sister	Concept
Ansel Adams	Entity
Funen	Entity
self-confidence	Concept
relative humidity	Concept
mallet	Concept
surprise	Concept
Typhoon Lupit	Entity
RVF	Concept
street	Concept
army	Concept
still-life	Concept
William Corson	Entity
Mitchell Brown	Entity
ordinary	Concept
Now What	Entity
silver	Concept
Qir	Entity
umber	Concept
Jim Beach	Entity
franchise	Concept
inch	Concept
insemination	Concept
lipogram	Concept
precognition	Concept
NGC 2264	Entity
notion	Concept
supervolcano	Concept
limousine	Concept
Azua	Entity
Ubu Roi	Entity
loser	Concept
Campo San Polo	Entity
Chris McKenna	Entity
hit	Concept
relay	Concept
giantess	Concept
colugo	Concept
Kingdom Hospital	Entity
Caddoan	Concept
Wang Xiaolong	Entity
status epilepticus	Concept
John Pankow	Entity
copywriter	Concept
MS	Entity
gegenschein	Concept
Dodie Bellamy	Entity
Tom Hanks	Entity
Timeless	Entity
VirtualDubMod	Entity
permanent magnet	Concept
planetary science	Concept
switcher	Concept
Dunbar	Entity
climate	Concept
Roy Hattersley	Entity
Analytical Engine	Entity
prison	Concept
growth	Concept
cribbage	Concept
Xpdf	Entity
wrongness	Concept
hound	Concept
Jenny Oropeza	Entity
macadam	Concept
treasure map	Concept
rappel	Concept
Irish	Entity
scallywag	Concept
eudaimonia	Concept
Durham	Entity
Roald Amundsen	Entity
Seanad	Concept
communization	Concept
Asia	Entity
extramarital sex	Concept
Yapese	Concept
SIMION	Entity
tenpence	Concept
mestranol	Concept
Honeyd	Entity
van	Concept
executive vice president	Concept
chuck steak	Concept
Surjit Singh Barnala	Entity
infatuation	Concept
Catoctin Mountain Park	Entity
Matt Dean	Entity
hand drill	Concept
podcast	Concept
punishment	Concept
Leonidas	Entity
Riverboat Discovery	Entity
freightage	Concept
acre	Concept
augmentation	Concept
potassium iodide	Concept
Day One	Entity
page	Concept
Cherryholmes	Entity
Monash Freeway	Entity
James Renwick	Entity
urinary bladder	Concept
William Cowper	Entity
shambles	Concept
floorshow	Concept
heartburn	Concept
storm	Concept
mycelium	Concept
Louisiana	Entity
suzerainty	Concept
shuttle	Concept
prerogative	Concept
City of London	Entity
accessibility	Concept
hell	Concept
Tomb Raider	Entity
Pauli	Entity
squall line	Concept
Introducing	Entity
Poitiers	Entity
diner	Concept
Coinage Act	Entity
dollar	Concept
webmail	Concept
Quantum mechanics	Concept
column	Concept
pinny	Concept
Nubian	Concept
editor	Concept
Cooperation and Development	Entity
shellac	Concept
vision	Concept
actor	Concept
camera	Concept
health facility	Concept
Visual FoxPro	Entity
Catherine Morland	Entity
Swimclub	Entity
greywacke	Concept
clerisy	Concept
Ernest Lehman	Entity
Golden Gate Park	Entity
violet	Concept
emery cloth	Concept
Pindar	Entity
Amsterdam Admirals	Entity
tropopause	Concept
lens	Concept
time	Concept
poet	Concept
pathfinder	Concept
fat	Concept
gasworks	Concept
Barney Bigard	Entity
Essex	Entity
Unix shell	Concept
casino	Concept
Wellington Road	Entity
Montlake Bridge	Entity
alluvium	Concept
negation	Concept
wildlife	Concept
anapsid	Concept
Hadronyche	Concept
Tupelo Press	Entity
noble	Concept
derogation	Concept
Pusey	Entity
fess	Concept
pe	Concept
Men at Work	Entity
leopard cat	Concept
discharge	Concept
Juan Cole	Entity
Jehuda Reinharz	Entity
El Nino	Entity
AAC	Entity
editorial	Concept
Messi	Entity
offensive	Concept
residence hall	Concept
Ken Russell	Entity
Hill cipher	Concept
Auguste Rodin	Entity
snowplow	Concept
mountain	Concept
sociology department	Concept
Equator	Entity
Murder One	Entity
USS Housatonic	Entity
formula	Concept
Ridge Racer	Entity
suer	Concept
global warming	Concept
flavin	Concept
Jane Elliott	Entity
tundra swan	Concept
Orange	Entity
denial-of-service attack	Concept
Dungeon Master	Entity
Stokes drift	Concept
spelt	Concept
Turtle Mountains	Entity
Henry Allan	Entity
dentist	Concept
Susan Strasberg	Entity
nonage	Concept
official	Concept
strangulation	Concept
rebel	Concept
phonetic transcription	Concept
copper	Concept
plastic	Concept
Bobby Williams	Entity
designer	Concept
environment	Concept
urus	Concept
jingoism	Concept
price of admission	Concept
entente	Concept
run batted in	Concept
Carlos Tosca	Entity
declaration	Concept
observation	Concept
voltage divider	Concept
robber	Concept
aftermath	Concept
tapis	Concept
Otto Lilienthal	Entity
syneresis	Concept
octillion	Concept
complaint	Concept
sea	Concept
Simon Upton	Entity
bush	Concept
pomegranate	Concept
mother	Concept
Mister Johnson	Entity
Rudolf Arnheim	Entity
Tufts University	Entity
Llaima	Entity
pawnbroker	Concept
autoresponder	Concept
happening	Concept
panorama	Concept
graphics	Concept
louse	Concept
Ronald Cass	Entity
crossover	Concept
snooze	Concept
drinking	Concept
Ape Escape	Entity
gabardine	Concept
open proxy server	Concept
wheeler	Concept
homophone	Concept
Ph.D.	Concept
palm	Concept
Universidad	Entity
Serpens Caput	Entity
dicoumarol	Concept
Sake	Entity
nuclear power plant	Concept
jug	Concept
lunchtime	Concept
lats	Concept
Mixtec	Entity
tank	Concept
footway	Concept
relevancy	Concept
Joseph Stalin	Entity
ball	Concept
photography	Concept
Mexico	Entity
neck	Concept
flooring	Concept
halfpenny	Concept
Hansel	Entity
flirting	Concept
northeaster	Concept
bird	Concept
shed	Concept
Kovel	Entity
delta	Concept
Goonellabah	Entity
parents	Concept
Michelle Thomas	Entity
open source	Concept
die	Concept
dhow	Concept
Phi Sigma Pi	Entity
Israel	Entity
lanugo	Concept
HDP	Entity
bank	Concept
Fyodor Dostoyevsky	Entity
statice	Concept
chest of drawers	Concept
cabin	Concept
pecan	Concept
Robert Barefoot	Entity
Comet Hale-Bopp	Entity
maliciousness	Concept
skin	Concept
Martin Brest	Entity
lightning rod	Concept
David Ball	Entity
flowage	Concept
Breidenbach	Entity
footman	Concept
Georgian era	Concept
Bradbury Science Museum	Entity
laburnum	Concept
Vat Phou	Entity
device	Concept
haloalkane	Concept
office automation	Concept
Aksu	Entity
Deck	Concept
kingbird	Concept
True Grit	Entity
USS Shiloh	Entity
Hugh Capet	Entity
Biebrza National Park	Entity
deposit	Concept
charlotte	Concept
mouse	Concept
teddy	Concept
blame	Concept
preparation	Concept
prefix	Concept
Fruitlands	Entity
Ivete Sangalo	Entity
Terrell High School	Entity
Muhammad Ali Jinnah	Entity
Flo Ziegfeld	Entity
William S. Harney	Entity
John Franks	Entity
anal sex	Concept
Tropical Storm Helene	Entity
standard	Concept
Wisconsin	Entity
banyan	Concept
Jane Clifton	Entity
hypertext markup language	Concept
animosity	Concept
Allakhazam	Entity
bridge	Concept
IRA	Concept
Pink Dot	Entity
warship	Concept
Scarlet Diva	Entity
postdoc	Concept
escrow	Concept
spotting	Concept
breechcloth	Concept
November	Entity
melanocyte	Concept
acceptance	Concept
hill	Concept
scrolling shooter	Concept
sitagliptin	Concept
coalition	Concept
Chromehounds	Entity
poundage	Concept
offense	Concept
rectory	Concept
baba	Concept
foster-child	Concept
Borregaard	Entity
seaquake	Concept
clastic	Concept
Showroom	Concept
century	Concept
broiler chicken	Concept
capital	Concept
Jay Cocks	Entity
botany	Concept
Texas	Entity
Richard Starkey	Entity
computer industry	Concept
puzzler	Concept
cricket	Concept
water balloon	Concept
Prowler	Entity
torsion	Concept
crooner	Concept
oratory	Concept
trust	Concept
steward	Concept
representative	Concept
Kansas	Entity
feudatory	Concept
burning	Concept
retail	Concept
Dustin Hoffman	Entity
Scott White	Entity
ruling	Concept
Tulsa World	Entity
shogunate	Concept
great-grandfather	Concept
Isle of Arran	Entity
nuclear energy	Concept
Alex Sink	Entity
Wakashan	Concept
OpenOffice	Entity
high commissioner	Concept
Nancy Milford	Entity
Creative	Entity
chowder	Concept
immurement	Concept
Turonian	Entity
quarry	Concept
Sherlock Holmes	Entity
Frank Harris	Entity
potato salad	Concept
business software	Concept
timepiece	Concept
stratum	Concept
gigahertz	Concept
straight	Concept
Francisco Pizarro	Entity
apparition	Concept
Karl Friedrich Gauss	Entity
machine	Concept
steeper	Concept
Capcom	Entity
make	Concept
ox	Concept
rainfall	Concept
photograph	Concept
Rigveda	Entity
strange quark	Concept
market research	Concept
La Veta Pass	Entity
weather	Concept
rhizome	Concept
clipping	Concept
conformist	Concept
capillary	Concept
Tulsa	Entity
inheritance	Concept
religion	Concept
Winston S. Churchill	Entity
margin	Concept
drumbeat	Concept
praise	Concept
gift shop	Concept
farming	Concept
Mollie Katzen	Entity
Queen Elizabeth	Entity
magnet school	Concept
Will Cotton	Entity
prayer	Concept
light	Concept
Collin Peterson	Entity
Agrippina	Entity
