crumpet	Concept
hostile fire	Concept
freight	Concept
czar	Concept
Stan Lee	Entity
Oklahoma Corporation Commission	Entity
dashi	Concept
Epistles	Entity
validity	Concept
Gene DeWeese	Entity
orison	Concept
Phil Silvers	Entity
hacksaw	Concept
evolutionary biologist	Concept
staginess	Concept
Act of Congress	Entity
Jemison	Entity
technophobia	Concept
binder	Concept
grant	Concept
Bear Creek	Entity
Seekonk	Entity
hyperboloid	Concept
deposition	Concept
Fast Company	Entity
subsidy	Concept
atmosphere	Concept
Animorphs	Entity
doodlebug	Concept
natural resources	Concept
blacktopping	Concept
commander-in-chief	Concept
Juliana Hatfield	Entity
property owner	Concept
smoothbore	Concept
makeover	Concept
station	Concept
kinetic theory	Concept
maltreatment	Concept
Callender	Entity
hydrogeology	Concept
Fort Sumter	Entity
Archaean	Entity
Bennington	Entity
explosion	Concept
Gerrard Winstanley	Entity
vaporization	Concept
lofepramine	Concept
Hero	Entity
Don Baldwin	Entity
