quintette	Concept
torch song	Concept
lullaby	Concept
traditional	Concept
Bruce Springsteen	Entity
Bedrock Records	Entity
twee pop	Concept
Phil Collins	Entity
The Ultimate	Entity
tone poems	Concept
harmonica blues	Concept
masses	Concept
quote	Concept
harp	Concept
The Shins	Entity
Fallen	Entity
Artwork	Entity
allegro	Concept
bass guitar	Concept
contemporary blues	Concept
percussion	Concept
bouffe	Concept
Back on Track	Entity
solo	Concept
kick drum	Concept
idyll	Concept
counterpoint	Concept
The Ventures	Entity
vocal pop	Concept
comic opera	Concept
Deja Entendu	Entity
Silverthorn	Entity
french pop	Concept
prelude	Concept
folk songs	Concept
Take Me Out	Entity
cantus firmus	Concept
Eurythmics	Entity
dulcimer	Concept
progressive	Concept
lead sheet	Concept
anticlimax	Concept
national anthem	Concept
jazz	Concept
Elton John	Entity
Madonna	Entity
clapper	Concept
tenor tuba	Concept
acid rock	Concept
nocturnes	Concept
disco music	Concept
chicago blues	Concept
drumming	Concept
roots rock	Concept
fantasies	Concept
contemporary big band	Concept
musette	Concept
opera	Concept
martial music	Concept
backup	Concept
leitmotiv	Concept
west coast	Concept
ragtime	Concept
crooning	Concept
scat singing	Concept
turntablists	Concept
cowboy	Concept
minstrelsy	Concept
waltz	Concept
mezzo-soprano	Concept
The Whole Shebang	Entity
The Beach Boys	Entity
Never Say Die	Entity
rhumba	Concept
celtic folk	Concept
duranguense	Concept
sarabande	Concept
chansons	Concept
chanting	Concept
southern rock	Concept
maracas	Concept
love-song	Concept
tone poem	Concept
Celtic rock	Concept
Iris	Entity
mbira	Concept
The War	Entity
new jack	Concept
disney	Concept
viola	Concept
brazilian jazz	Concept
spoken word	Concept
symphonic poem	Concept
Origin	Entity
dance pop	Concept
Hollywood	Entity
funk rock	Concept
music box	Concept
neo-soul	Concept
gong	Concept
xylophone	Concept
traditional folk	Concept
euphonium	Concept
conductor	Concept
Antichrist Superstar	Entity
The Clovers	Entity
rocksteady	Concept
pop metal	Concept
Depeche Mode	Entity
musical bow	Concept
Yessongs	Entity
punk rock	Concept
metalhead	Concept
hot jazz	Concept
sonatina	Concept
christmas	Concept
arrangement	Concept
incidental music	Concept
scottish folk	Concept
kwela	Concept
alphorn	Concept
etudes	Concept
recorder	Concept
coda	Concept
krautrock	Concept
Good Vibrations	Entity
Russian pop	Concept
latin rock	Concept
minuets	Concept
Salvation	Entity
caroling	Concept
electronic pop	Concept
sextet	Concept
sheet music	Concept
classic rock	Concept
invention	Concept
Paint It Black	Entity
track	Concept
hornpipe	Concept
accompaniment	Concept
Genesis	Entity
twelve-tone music	Concept
continuo	Concept
duo	Concept
ballads	Concept
AKB48	Entity
Sex Pistols	Entity
electric guitar	Concept
Rolling Stones	Entity
realisation	Concept
delta blues	Concept
bongo drum	Concept
programme music	Concept
Pink Floyd	Entity
Grappelli	Entity
X Japan	Entity
Elvis Costello	Entity
Bounce	Entity
cymbal	Concept
double bass	Concept
rock and roll	Concept
dance music	Concept
baton	Concept
heavy metal	Concept
sea chantey	Concept
solfege	Concept
Peter Gabriel	Entity
ukelele	Concept
Dream Theater	Entity
finger cymbals	Concept
Only U	Entity
musical composition	Concept
drums	Concept
recitative	Concept
theme song	Concept
piece of music	Concept
cadenza	Concept
excerpt	Concept
Fursaxa	Entity
ambient	Concept
Steve Mackey	Entity
chantey	Concept
Public Enemy	Entity
bachata	Concept
rock music	Concept
monochord	Concept
folk rock	Concept
doo wop	Concept
ground	Concept
Ira D. Sankey	Entity
tambourine	Concept
progressive metal	Concept
idm	Concept
dithyramb	Concept
section	Concept
Nightwish	Entity
Katy Perry	Entity
ballroom music	Concept
merengue	Concept
disco	Concept
motive	Concept
clavichord	Concept
americana	Concept
Up All Night	Entity
refrain	Concept
salutation	Concept
cello	Concept
southern gospel	Concept
popular music	Concept
autoharp	Concept
rondeau	Concept
mallet	Concept
antiphonary	Concept
british punk	Concept
acoustic guitar	Concept
classic big band	Concept
King Crimson	Entity
irish folk	Concept
cutting	Concept
Sky Blue Sky	Entity
art rock	Concept
acoustic blues	Concept
harmonica	Concept
Agoraphobia	Entity
Dark Passion Play	Entity
Wrapped Around	Entity
intonation	Concept
sitar	Concept
finale	Concept
keyboardist	Concept
sing-a-longs	Concept
dubstep	Concept
psychedelic rock	Concept
musical arrangement	Concept
shred	Concept
Hawkwind	Entity
wood block	Concept
Group Therapy	Entity
singer-songwriter	Concept
timpani	Concept
Pavarotti	Entity
horn	Concept
northern	Concept
light opera	Concept
AC/DC	Entity
oldies	Concept
bagpipe	Concept
marching music	Concept
washboard	Concept
gramophone	Concept
octet	Concept
passage	Concept
Donkey	Entity
american punk	Concept
harmonisation	Concept
emo	Concept
David Bowie	Entity
ambient pop	Concept
mandolin	Concept
Johnny Cash	Entity
recapitulation	Concept
cadence	Concept
Supernatural	Entity
harmonization	Concept
vocal blues	Concept
orchestra bells	Concept
pavane	Concept
grupero	Concept
gigue	Concept
pan flute	Concept
whistling	Concept
sonata	Concept
Yankee Hotel Foxtrot	Entity
Sonic Youth	Entity
diminution	Concept
piccolo trumpet	Concept
Stereolab	Entity
canto	Concept
scherzo	Concept
The Cure	Entity
Handbags and Gladrags	Entity
monody	Concept
adult alternative	Concept
tenor drum	Concept
Roar	Entity
gospel singing	Concept
Grateful Dead	Entity
steel drums	Concept
death metal	Concept
cornet	Concept
pastoral	Concept
part	Concept
chanson	Concept
soprano saxophone	Concept
triangle	Concept
alternative rock	Concept
blues	Concept
Taiwanese pop	Concept
instrumental music	Concept
Jimi Hendrix	Entity
dub	Concept
adagio	Concept
canon	Concept
Louis Armstrong	Entity
fanfare	Concept
bell lyre	Concept
singsong	Concept
alternative metal	Concept
texas blues	Concept
amplifier	Concept
modulation	Concept
toccata	Concept
clarinet	Concept
chamber music	Concept
pedal	Concept
Metallica	Entity
Brian Eno	Entity
Welcome the Night	Entity
tenor saxophone	Concept
dance	Concept
Robert Cray	Entity
outlaw country	Concept
chanty	Concept
The Crusade	Entity
karaoke	Concept
dixieland	Concept
rap music	Concept
Indorock	Entity
serialism	Concept
güiro	Concept
symphony	Concept
garage punk	Concept
preludes	Concept
fugue	Concept
rap	Concept
cittern	Concept
punk	Concept
crumhorn	Concept
rock'n'roll	Concept
trip-hop	Concept
hardcore	Concept
plainsong	Concept
traditional blues	Concept
Trapped	Entity
pop music	Concept
jam bands	Concept
theremin	Concept
Dizzy Gillespie	Entity
Thornography	Entity
Led Zeppelin	Entity
easy listening	Concept
singalong	Concept
soundtrack	Concept
lullabies	Concept
cacophony	Concept
ska punk	Concept
serial music	Concept
Backstreet Boys	Entity
straight edge	Concept
The Clash	Entity
playback	Concept
temple blocks	Concept
For Sleepyheads Only	Entity
Lose My Breath	Entity
rock-and-roll	Concept
jamaican ska	Concept
neotraditional	Concept
hymn	Concept
flourish	Concept
trumpet	Concept
Frank Zappa	Entity
claves	Concept
Shamrock Diaries	Entity
Gentle Giant	Entity
singing	Concept
trad	Concept
The Beatles	Entity
choral	Concept
Wu-Tang Clan	Entity
rock guitarists	Concept
grate	Concept
gregorian chant	Concept
smooth jazz	Concept
choir	Concept
kalimba	Concept
Apoptygma Berzerk	Entity
songbook	Concept
conga	Concept
tango	Concept
Boy George	Entity
soundtrack album	Concept
lyre	Concept
capriccio	Concept
character piece	Concept
contemporary folk	Concept
thumb piano	Concept
bassoon	Concept
homophony	Concept
leitmotif	Concept
organ	Concept
funk	Concept
musical	Concept
Irma	Entity
crash cymbals	Concept
Fleetwood Mac	Entity
intro	Concept
macumba	Concept
My My	Entity
Bob Dylan	Entity
boogie	Concept
western swing	Concept
solmization	Concept
djembe	Concept
Deep Purple	Entity
Kenny Hickey	Entity
yodeling	Concept
operettas	Concept
shawm	Concept
Mackey Feary	Entity
transverse flute	Concept
electric blues	Concept
Salvatore Adamo	Entity
polonaise	Concept
progressive rock	Concept
industrial	Concept
study	Concept
musical passage	Concept
coloratura	Concept
Iron Maiden	Entity
bugler	Concept
syncopation	Concept
Coil	Entity
Miles Davis	Entity
surf guitar	Concept
contrabass clarinet	Concept
rockabilly	Concept
Trap House	Entity
baritone saxophone	Concept
flugelhorn	Concept
psalm	Concept
gavotte	Concept
postlude	Concept
mazurkas	Concept
Peace of Mind	Entity
scat	Concept
Duke Ellington	Entity
folk song	Concept
violoncello	Concept
urban folk	Concept
Happily Ever After	Entity
glam	Concept
doo-wop	Concept
Björk	Entity
David Bisbal	Entity
serenade	Concept
Brazilian rock	Concept
French rock	Concept
ratchet	Concept
harmony	Concept
Massive Attack	Entity
Sepultura	Entity
madrigal	Concept
proto punk	Concept
Wagner	Entity
Loaded	Entity
Angels Fall First	Entity
timbales	Concept
extract	Concept
british invasion	Concept
polyphonic music	Concept
Nightshift	Entity
bass clarinet	Concept
rackett	Concept
ranchera	Concept
adult contemporary	Concept
folksong	Concept
orchestral jazz	Concept
hip-hop	Concept
motif	Concept
melodic phrase	Concept
Tom Waits	Entity
acid jazz	Concept
The Chariot	Entity
punk-pop	Concept
drinking song	Concept
chant	Concept
recessional	Concept
big beat	Concept
grand piano	Concept
The Reeling	Entity
Liz Phair	Entity
old-time country	Concept
violin	Concept
musical harmony	Concept
Goldfrapp	Entity
passion	Concept
Hot Issue	Entity
Edwin Birdsong	Entity
ethnic music	Concept
trio sonata	Concept
