Wang Xin	Entity
relative price	Concept
homeostasis	Concept
stakes	Concept
Nara	Entity
Milton Shapp	Entity
bulkhead	Concept
degree	Concept
Parveen Babi	Entity
curriculum	Concept
crossover	Concept
vehicle	Concept
time-ball	Concept
John Munroe	Entity
journal	Concept
Anthony Caro	Entity
university	Concept
smoothbore	Concept
health economics	Concept
matador	Concept
NGC 2264	Entity
Caddoan	Concept
gluon	Concept
prefix	Concept
Iceland	Entity
mail	Concept
ostracism	Concept
Chuck Schumer	Entity
timepiece	Concept
turn	Concept
The Seven	Entity
font	Concept
Moscow	Entity
climate	Concept
wine	Concept
Surdas	Entity
bear	Concept
Springboro	Entity
smoke	Concept
actuator	Concept
Indonesia	Entity
glade	Concept
Hany Farid	Entity
rockfish	Concept
Swimclub	Entity
chaldron	Concept
umber	Concept
department head	Concept
money	Concept
John Drew	Entity
