innovation	Concept
Middlesex Guildhall	Entity
gasworks	Concept
strategy	Concept
Neon Genesis Evangelion	Entity
Montlake Bridge	Entity
TV	Concept
soil pipe	Concept
gold coin	Concept
John Passmore	Entity
emancipation	Concept
Samuel Johnson	Entity
collection	Concept
Standerton	Entity
gdbserver	Concept
prototype	Concept
bird sanctuary	Concept
Indians	Entity
apartment	Concept
Maginot	Entity
dragnet	Concept
felicity	Concept
Windows	Entity
orison	Concept
Fayette County	Entity
Sonoma State University	Entity
Turistas	Entity
USS Housatonic	Entity
day	Concept
delicacy	Concept
general assembly	Concept
sister	Concept
heedfulness	Concept
equitation	Concept
Scott City	Entity
tacking	Concept
teleconference	Concept
WinSCP	Entity
trust	Concept
cheat	Concept
village	Concept
Mohammad Yousuf	Entity
republic	Concept
John Talbot	Entity
spam	Concept
wrestler	Concept
supervision	Concept
Deep learning	Concept
Drawing Restraint 9	Entity
Test Site	Entity
Fredericksburg	Entity
brush-off	Concept
Reddit	Entity
AT&T	Entity
Canyonlands	Entity
fosterling	Concept
Mexico	Entity
Fort Klamath	Entity
foreclosure	Concept
PubMed	Entity
cox	Concept
Copper oxide	Concept
palisade	Concept
Kansas	Entity
accolade	Concept
possession	Concept
issuer	Concept
sailing ship	Concept
heartburn	Concept
stater	Concept
video	Concept
Aare	Entity
Vat Phou	Entity
wind	Concept
referee	Concept
archeologist	Concept
Dalbergia melanoxylon	Concept
picture	Concept
kid	Concept
golden rule	Concept
smew	Concept
pontiff	Concept
palette	Concept
Jackie Mittoo	Entity
September	Entity
logotype	Concept
specialist	Concept
disengagement	Concept
headquarters	Concept
sawmill	Concept
Blithe Spirit	Entity
veratrum	Concept
25th Hour	Entity
Tonto Creek	Entity
Poeciliopsis	Concept
suite	Concept
judge	Concept
cowpox	Concept
W. Browning	Entity
pollution	Concept
psychedelic	Concept
ranch	Concept
retirement benefit	Concept
chairman	Concept
Russell Shorto	Entity
professional designation	Concept
vindication	Concept
Jon Clardy	Entity
voltage divider	Concept
porphyrin	Concept
rotunda	Concept
larder	Concept
cypher	Concept
stratum	Concept
sigma	Concept
witchgrass	Concept
jug	Concept
retribution	Concept
groundwater	Concept
Griselda	Entity
ironing	Concept
junk	Concept
Maryland	Entity
Chromehounds	Entity
outreach	Concept
library	Concept
singlet	Concept
lost cause	Concept
delegacy	Concept
Rheal Cormier	Entity
lynching	Concept
melanocyte	Concept
angular momentum	Concept
ridge	Concept
Wellington Road	Entity
dioxide	Concept
pollock	Concept
disobedience	Concept
variety	Concept
Kohler	Entity
program	Concept
temperament	Concept
Nuptse	Entity
backwash	Concept
radon	Concept
granadilla	Concept
dinky	Concept
exculpation	Concept
private eye	Concept
viola	Concept
lemon verbena	Concept
agitation	Concept
lift	Concept
swamp gum	Concept
South Kensington	Entity
Kingdom Hospital	Entity
Analytical Engine	Entity
sandbox	Concept
Aryabhata	Entity
grant	Concept
poundage	Concept
Muhammad Ali Jinnah	Entity
afterlife	Concept
tricolour	Concept
Timeless	Entity
benefaction	Concept
clerid	Concept
Ansel Adams	Entity
permanent magnet	Concept
Wii	Entity
Make the Grade	Entity
Now What	Entity
real estate	Concept
Finding Forrester	Entity
La	Concept
Pyrrhus	Entity
mayweed	Concept
reactionary	Concept
Hill cipher	Concept
stairway	Concept
capillary	Concept
FOTS	Concept
Winterthur	Entity
entente	Concept
Sigrid Nunez	Entity
Dorothea Puente	Entity
res judicata	Concept
Callender	Entity
river	Concept
Skara Brae	Entity
way out	Concept
enrollee	Concept
chapter	Concept
Tupelo Press	Entity
Jump Cut	Entity
madam	Concept
Jeremy Nathans	Entity
farmer	Concept
tutsan	Concept
urus	Concept
Palazzo Farnese	Entity
diameter	Concept
gegenschein	Concept
page	Concept
freight	Concept
Chris Phillips	Entity
rosiness	Concept
behaviourism	Concept
journalist	Concept
Dave Littlefield	Entity
slop	Concept
interface	Concept
wire	Concept
macedonia	Concept
Java	Entity
flare	Concept
pottery	Concept
Seanad	Concept
Kathryn Werdegar	Entity
Sidney R. Yates	Entity
shortsightedness	Concept
dress	Concept
lira	Concept
Intelligence Bureau	Entity
queenfish	Concept
camera	Concept
Sherlock Holmes	Entity
Chromosome 9	Entity
Leonidas	Entity
single tax	Concept
New Jersey	Entity
disciple	Concept
Buchenwald	Entity
MetroLink	Entity
Trimble	Entity
full stop	Concept
Roald Amundsen	Entity
dulcimer	Concept
collage	Concept
Frederick Sanger	Entity
The Infinite Mind	Entity
hometown	Concept
negation	Concept
frogmouth	Concept
declaration	Concept
Yapese	Concept
Galeras	Entity
Robert De Niro	Entity
rainfall	Concept
President Lyndon Johnson	Entity
standard	Concept
knickers	Concept
RVF	Concept
shambles	Concept
dam	Concept
Edmund Burke	Entity
Act of Congress	Entity
Don Baldwin	Entity
distributer	Concept
complaint	Concept
IBM	Entity
convenience	Concept
State Highway 17	Entity
skepticism	Concept
Hurricane Dennis	Entity
escheat	Concept
Matt Dean	Entity
owner	Concept
witness	Concept
delta	Concept
hornist	Concept
feebleness	Concept
Norfolk	Entity
happening	Concept
Manarola	Entity
boson	Concept
Winston S. Churchill	Entity
Walter Boyce	Entity
Hurricane Fabian	Entity
Morris Carnovsky	Entity
brachydactyly	Concept
tension	Concept
defeat	Concept
running	Concept
regiment	Concept
halfpenny	Concept
tropical storm	Concept
Otto von Habsburg	Entity
Long Tack Sam	Entity
plasma	Concept
Pressburg	Entity
bread	Concept
reading teacher	Concept
dwarf planet	Concept
bulk	Concept
steward	Concept
top side	Concept
aerodrome	Concept
Suzy Favor Hamilton	Entity
dirt	Concept
judgment	Concept
John Osborne	Entity
Ben Gardner	Entity
Fagopyrum	Concept
strappado	Concept
dejection	Concept
Vilfredo Pareto	Entity
Laksar	Entity
platform	Concept
mask	Concept
coast	Concept
waiver	Concept
literature	Concept
Alexandre Gustave Eiffel	Entity
Nancy	Entity
consultant	Concept
atmosphere	Concept
kinetic theory	Concept
deposit	Concept
George Soros	Entity
scouter	Concept
switch	Concept
Savonarola	Entity
Straight River	Entity
gift shop	Concept
Indra	Entity
outlaw	Concept
Fast Company	Entity
leger	Concept
philia	Concept
bottled water	Concept
True Life	Entity
windage	Concept
Gerrard Winstanley	Entity
Hudson	Entity
till	Concept
convert	Concept
corporation	Concept
gateway	Concept
margin	Concept
Bomberman	Entity
railroad	Concept
fifty	Concept
run batted in	Concept
slut	Concept
representative	Concept
Catholic	Concept
pearl	Concept
spare	Concept
Allakhazam	Entity
mischance	Concept
index	Concept
rollercoaster	Concept
convertibility	Concept
ox	Concept
battle of Leuctra	Entity
Hamilton Airport	Entity
Elizabeth Eisenstein	Entity
Belarus	Entity
Dominique Voynet	Entity
share	Concept
Creative	Entity
vivisection	Concept
John Franks	Entity
AI	Concept
precipitation	Concept
Green	Concept
Cumberland Bay	Entity
Jerry Oltion	Entity
Julius Stone	Entity
prince consort	Concept
reconnoitering	Concept
tax haven	Concept
gamesmanship	Concept
snowplow	Concept
Kristin Luker	Entity
Cambridge	Entity
arms	Concept
aqueduct	Concept
overpass	Concept
glen	Concept
ossification	Concept
twinjet	Concept
reflex response	Concept
prayer	Concept
proton pump	Concept
Epistles	Entity
teacher	Concept
grenadilla	Concept
discharge	Concept
seminar	Concept
restriction fragment	Concept
general contractor	Concept
Mohave Community College	Entity
blank	Concept
Nyahururu	Entity
synchronizer	Concept
medalist	Concept
attic	Concept
anycast	Concept
silhouette	Concept
wiper motor	Concept
midfield	Concept
honesty	Concept
par	Concept
mentor	Concept
space	Concept
Roy Hattersley	Entity
curling	Concept
tempestuousness	Concept
grenade	Concept
fish	Concept
island	Concept
valedictorian	Concept
camlet	Concept
nuclear medicine	Concept
damages	Concept
noble	Concept
autograph	Concept
spelunker	Concept
Tacitus	Entity
still-life	Concept
official	Concept
Jane Clifton	Entity
front	Concept
seafloor	Concept
compound	Concept
kaon	Concept
high commissioner	Concept
carting	Concept
forum	Concept
teddy	Concept
Aesculapius	Entity
selector	Concept
Port Chester	Entity
adage	Concept
Prentice Hall	Entity
earthquake	Concept
casserole	Concept
galoshes	Concept
Showroom	Concept
Ian Bell	Entity
Misti	Entity
Dionysia	Concept
Photek	Entity
coda	Concept
walk	Concept
oligoastrocytoma	Concept
disincentive	Concept
pool	Concept
cosmic dust	Concept
Michael Slote	Entity
language	Concept
bolster	Concept
Hotel Europe	Entity
junkware	Concept
Meat Puppets	Entity
shift	Concept
penal colony	Concept
chronic	Concept
moderator	Concept
open proxy server	Concept
Aksu	Entity
selection	Concept
Sigma Lambda Beta	Entity
government	Concept
jacket	Concept
Tulsa World	Entity
Abutilon theophrasti	Concept
Altai Mountains	Entity
accessibility	Concept
plume	Concept
academician	Concept
Los Angeles	Entity
contrast agent	Concept
engine	Concept
viper	Concept
Chris McKenna	Entity
Richard Starkey	Entity
grounds	Concept
point	Concept
Deutschland	Entity
excitement	Concept
backstay	Concept
perfidiousness	Concept
authoritarian regime	Concept
Gurf Morlix	Entity
homophone	Concept
milkwort	Concept
Pusey	Entity
recall	Concept
photograph	Concept
Qir	Entity
academic year	Concept
Surjit Singh Barnala	Entity
rap music	Concept
breakwater	Concept
overflow	Concept
Game Boy Advance	Entity
battle of Plataea	Entity
punishment	Concept
Eliezer Yudkowsky	Entity
rat-catcher	Concept
adobe	Concept
economic policy	Concept
Ilex cassine	Concept
rhizome	Concept
John Pankow	Entity
buckle	Concept
net	Concept
tortilla chip	Concept
cast	Concept
conformist	Concept
Pure Pinball	Entity
valuation	Concept
Michael Owen	Entity
James Sallis	Entity
Brasilia	Entity
Jimmy Stewart	Entity
festival	Concept
actor	Concept
Carly Fiorina	Entity
horse	Concept
SpamBayes	Entity
Agrippina	Entity
phone call	Concept
gray	Concept
Forest Way	Entity
James Hogg	Entity
credit	Concept
anal sex	Concept
ground level	Concept
offensive	Concept
Supersonics	Entity
El Nino	Entity
smuggler	Concept
darkey	Concept
state of nature	Concept
sculpture	Concept
pawnbroker	Concept
Tom Hanks	Entity
dentist	Concept
A1 motorway	Entity
antagonism	Concept
note	Concept
praise	Concept
killer	Concept
limousine	Concept
Gerry Davis	Entity
molecule	Concept
The Race	Entity
carat	Concept
flattop	Concept
Paul Lafargue	Entity
Inland Revenue	Concept
deregulating	Concept
landgrave	Concept
petty officer	Concept
capital	Concept
drug of abuse	Concept
calmodulin	Concept
line of duty	Concept
Voyager 1	Entity
alb	Concept
Umayyad Mosque	Entity
invalid	Concept
USS Shiloh	Entity
peasant	Concept
viceroy	Concept
trust company	Concept
Jonathan Freedland	Entity
Bowhead whale	Concept
Internet	Concept
public service	Concept
flooding	Concept
Half-Life	Entity
Turonian	Entity
die	Concept
Isle of Arran	Entity
Nahum Sonenberg	Entity
eschaton	Concept
lysine	Concept
sliminess	Concept
Cancun	Entity
Hillbrow	Entity
headshot	Concept
avulsion	Concept
maltreatment	Concept
LRRK2	Entity
Transportation	Entity
Equator	Entity
megabyte	Concept
leopard cat	Concept
chuck steak	Concept
flashlight	Concept
general	Concept
nitrification	Concept
warlord	Concept
Prentiss	Entity
autoresponder	Concept
ounce	Concept
Dara Horn	Entity
MathWorks	Entity
Dance Mix	Entity
advocacy	Concept
polysemy	Concept
vigabatrin	Concept
S4	Concept
studio	Concept
influenza	Concept
timber	Concept
Coliseum	Entity
small cap	Concept
vision	Concept
Erika Nordby	Entity
mangonel	Concept
lunchtime	Concept
sunspot	Concept
Jehuda Reinharz	Entity
bomber	Concept
Greek	Entity
swashbuckler	Concept
tragedy	Concept
Laurel Touby	Entity
Maxims	Entity
Louisiana	Entity
employee	Concept
John Fitzgerald Kennedy	Entity
flipper	Concept
prerogative	Concept
mill	Concept
fault	Concept
prescription	Concept
antioxidant	Concept
volcanic rock	Concept
binder	Concept
fiber	Concept
clopidogrel bisulfate	Concept
coiner	Concept
Alternative Tentacles	Entity
human migration	Concept
coma	Concept
spending	Concept
release notes	Concept
docker	Concept
fire	Concept
aridity	Concept
suzerainty	Concept
Jesse Alexander	Entity
bowsprit	Concept
global warming	Concept
bramble	Concept
southwestward	Concept
Three Graces	Entity
nag	Concept
doldrums	Concept
fishmeal	Concept
corpus delicti	Concept
thiocyanate	Concept
Lucrezia Borgia	Entity
Dorothy Richardson	Entity
Keshu	Entity
comic	Concept
wing	Concept
Cocina	Entity
loser	Concept
road rage	Concept
test	Concept
gypsum	Concept
pe	Concept
malware	Concept
bloodguilt	Concept
Leon Festinger	Entity
statice	Concept
sodium borohydride	Concept
outfit	Concept
copywriter	Concept
workplace	Concept
brownie	Concept
St. Vitus	Entity
Michigan	Entity
Stanford	Entity
Nikon F5	Entity
Myers-Briggs Type Indicator	Entity
portraitist	Concept
open source	Concept
weather forecasting	Concept
ulnar artery	Concept
petition	Concept
sedative	Concept
prison	Concept
Dustin Hoffman	Entity
Michael Costa	Entity
Catoctin Mountain Park	Entity
haloalkane	Concept
acquiescence	Concept
eisteddfod	Concept
kerchief	Concept
bondman	Concept
patent	Concept
seamster	Concept
jeopardy	Concept
Jenny Oropeza	Entity
Jurmo	Entity
Sajid Mahmood	Entity
Robert Barefoot	Entity
St. Bernard Software	Entity
proprioception	Concept
Turrican	Entity
Swami Haridas	Entity
palm	Concept
augmentation	Concept
fasces	Concept
Andronicus of Rhodes	Entity
Irish	Entity
belt	Concept
airlock	Concept
The Mail	Entity
persecution	Concept
Tellico Reservoir	Entity
capsule	Concept
Halevi	Entity
secular	Concept
brittle	Concept
tahini	Concept
conditionality	Concept
20th century	Concept
Monty Python	Entity
wrestle	Concept
coffee	Concept
November	Entity
Leipzig	Entity
Reckless Kelly	Entity
spinal fusion	Concept
Jack Trout	Entity
Monster Magnet	Entity
straw man	Concept
White Star	Entity
Bob Beers	Entity
HDP	Entity
colugo	Concept
soul mate	Concept
Circle Jerks	Entity
literary critic	Concept
Vorukh	Entity
styrofoam	Concept
Grimm	Entity
panorama	Concept
jerky	Concept
Sphagnum	Concept
corneum	Concept
giro	Concept
white coat	Concept
pomegranate	Concept
prime minister	Concept
Ellida	Concept
subtropics	Concept
StarCraft	Entity
Haven	Entity
Albuquerque	Entity
burgh	Concept
emery cloth	Concept
blind	Concept
write-off	Concept
grit	Concept
solfege	Concept
autocracy	Concept
dealer	Concept
nonsmoker	Concept
photomicrograph	Concept
subsoil	Concept
spot price	Concept
supervolcano	Concept
marriage	Concept
street	Concept
bigtooth aspen	Concept
magnetometer	Concept
interpellation	Concept
hard worker	Concept
pulse	Concept
Verlot	Entity
Amoy	Concept
Taco Cabana	Entity
crisis	Concept
Quantum mechanics	Concept
St. Augustine	Entity
viscometry	Concept
wingspread	Concept
community	Concept
song thrush	Concept
dub	Concept
solid	Concept
transit	Concept
cocoa bean	Concept
crab	Concept
axile placentation	Concept
complement	Concept
beneficiary	Concept
apparition	Concept
horseshoer	Concept
pinny	Concept
tundra swan	Concept
VirtualDubMod	Entity
investment	Concept
paragonite	Concept
maharaja	Concept
joystick	Concept
Jemison	Entity
Niels Bohr	Entity
posey	Concept
staginess	Concept
carborundum	Concept
Azua	Entity
metropolitan area	Concept
Planck	Entity
horseman	Concept
department	Concept
Belfast Lough	Entity
management	Concept
Phi Sigma Sigma	Entity
Georgian era	Concept
extramarital sex	Concept
bird	Concept
oriflamme	Concept
David Gustafson	Entity
imposture	Concept
liquid	Concept
lipstick	Concept
spearmint	Concept
Margaret Robinson	Entity
grafting	Concept
Don McKellar	Entity
affectionateness	Concept
cyclic guanosine monophosphate	Concept
Aramaic	Entity
Osbert Sitwell	Entity
in-joke	Concept
diffraction	Concept
bell-bottoms	Concept
debt	Concept
Pacaya	Entity
vegetarian	Concept
bioenergy	Concept
cereal	Concept
Joan Silber	Entity
promulgation	Concept
urinary bladder	Concept
fresco	Concept
agriculture	Concept
collegian	Concept
eudaimonia	Concept
Cherryholmes	Entity
article	Concept
Shoot the Dog	Entity
Scott	Entity
James Nash	Entity
flooring	Concept
Wakashan	Concept
Paynes Creek	Entity
counterclaim	Concept
Grigori Perelman	Entity
Kennedy	Entity
self-confidence	Concept
court	Concept
Roos	Entity
editorial	Concept
malfeasance	Concept
charlotte	Concept
mark	Concept
magnetic dipole	Concept
Martinair	Entity
cloister	Concept
monoclonal	Concept
Tharsis	Entity
harrow	Concept
commoner	Concept
precision	Concept
Paul Philippe Cret	Entity
fence	Concept
country	Concept
Slovenia	Entity
potter	Concept
Terrell High School	Entity
tortilla	Concept
Grani	Entity
Angostura Reservoir	Entity
agar	Concept
Matthew Murphy	Entity
eversion	Concept
Aaron Copland	Entity
Darius Painter	Entity
Augustine Volcano	Entity
William Jordan	Entity
sub-interval	Concept
road	Concept
spile	Concept
phonics	Concept
Ceuta	Entity
Dunbar	Entity
harasser	Concept
spaceport	Concept
Introducing	Entity
Zinc	Entity
click	Concept
surd	Concept
marketing research	Concept
immurement	Concept
perry	Concept
student council	Concept
Eilean Donan	Entity
medical care	Concept
balsa raft	Concept
distribution	Concept
IRA	Concept
petrology	Concept
WSRP	Entity
Busta Rhymes	Entity
dashi	Concept
breechcloth	Concept
caldera	Concept
Lawrence	Entity
owner-occupier	Concept
OpenOffice	Entity
Lancashire	Entity
endeavour	Concept
dormouse	Concept
Magnificent Mile	Entity
great-grandfather	Concept
surf	Concept
pocketbook	Concept
Mota	Entity
phonetic transcription	Concept
Arapaho	Entity
GuideStar	Entity
village hall	Concept
search engine	Concept
Simon Upton	Entity
hardpan	Concept
burr oak	Concept
hero	Concept
pod	Concept
Fort Sumter	Entity
cricopharyngeus	Concept
capability	Concept
dexterity	Concept
New Orleans	Entity
flocculation	Concept
XML	Entity
field hospital	Concept
plumbing fixtures	Concept
Prowler	Entity
Johan Remkes	Entity
Harold W. Dodds	Entity
insight	Concept
stucco	Concept
tank	Concept
Ukraine	Entity
syllabication	Concept
guard	Concept
Pink Dot	Entity
shoulder	Concept
elimination	Concept
Union Station	Entity
budget	Concept
designation	Concept
placebo effect	Concept
escrow	Concept
reporter	Concept
school year	Concept
Emmeline Pankhurst	Entity
Boulder Creek	Entity
restaurant	Concept
ten thousand	Concept
mugwump	Concept
proteolysis	Concept
prexy	Concept
escudo	Concept
heritage	Concept
Mjolnir	Entity
plumbing	Concept
quietness	Concept
archduke	Concept
guts	Concept
IBM 1620	Entity
Hurricane Epsilon	Entity
emperor	Concept
shopping	Concept
hurdling	Concept
futurist	Concept
plantation	Concept
suspension	Concept
perdition	Concept
Scott Styris	Entity
New Zealand	Entity
gelatin	Concept
indisposition	Concept
banyan	Concept
Macklin	Entity
Taiwan Relations Act	Entity
Himalaya	Entity
chowder	Concept
Semipalatinsk Test Site	Entity
palomino	Concept
tendentiousness	Concept
FutureGen	Entity
coder	Concept
emerald	Concept
Campo San Polo	Entity
Mohammed	Entity
sou	Concept
unintelligibility	Concept
hillock	Concept
tornado	Concept
racial profiling	Concept
dungeon	Concept
brute	Concept
Cortes	Entity
foolishness	Concept
policy	Concept
laser	Concept
Jane Elliott	Entity
Pinot blanc	Concept
puzzler	Concept
avenue	Concept
proof	Concept
anglophile	Concept
chronicler	Concept
H-Net	Entity
megathrust earthquake	Concept
John Romer	Entity
Robert Boyle	Entity
eponychium	Concept
Kingdom	Concept
Dennis Lillee	Entity
Newdale	Entity
riptide	Concept
metritis	Concept
driving	Concept
redundancy check	Concept
real world	Concept
shipping	Concept
disk	Concept
Talim	Entity
dollar	Concept
filial piety	Concept
Audrey Hepburn	Entity
particle	Concept
Local Group	Entity
frequence	Concept
Coinage Act	Entity
chip	Concept
neurohypophysis	Concept
settlement	Concept
cooking ingredient	Concept
militarization	Concept
Vernon Jarrett	Entity
Republic of Turkey	Entity
Quercus ilex	Concept
earphones	Concept
avant-garde	Concept
Africa	Entity
Klaus Nomi	Entity
Vietnam	Entity
light pollution	Concept
Greccio	Entity
Hannity	Entity
Como	Entity
Carlos Tosca	Entity
zero	Concept
differential	Concept
pipe	Concept
prince	Concept
customer	Concept
view	Concept
PlayStation Portable	Entity
highschool	Concept
intermittent claudication	Concept
Reuel Marc Gerecht	Entity
cricket	Concept
power point	Concept
lava	Concept
saprolite	Concept
signal	Concept
Vera Nazarian	Entity
edger	Concept
CISC	Concept
bastinado	Concept
Pope Pius X	Entity
bounty hunter	Concept
Adams Express Company	Entity
Serpens Caput	Entity
Landscape Arch	Entity
Bislama	Entity
Heming	Entity
dividend	Concept
Carlos Frenk	Entity
special forces	Concept
David T. Ellwood	Entity
Paul Mellars	Entity
birdwatching	Concept
Copernic	Entity
lie detector	Concept
urolith	Concept
nuclear energy	Concept
check-in	Concept
beacon	Concept
horsepower	Concept
reliability	Concept
longbow	Concept
Arthur Ashe	Entity
Mike Allen	Entity
Panthera pardus	Concept
domain	Concept
Nsanje	Entity
Helen of Troy	Entity
Harmonia axyridis	Concept
True Grit	Entity
tectonic uplift	Concept
ghrelin	Concept
Mossbank	Entity
interdict	Concept
deoxyribonucleic acid	Concept
risotto	Concept
Turkey	Entity
laburnum	Concept
Bernina Express	Entity
Winsor School	Entity
macroeconomics	Concept
Richard Barnes Mason	Entity
Merriam-Webster	Entity
Xpdf	Entity
hand drill	Concept
sorcerer	Concept
shogunate	Concept
Phoebe Buffay	Entity
summerhouse	Concept
short-term memory	Concept
baronetcy	Concept
exponent	Concept
hill	Concept
Sam Rainsy	Entity
Jean Piaget	Entity
spell-checker	Concept
business concern	Concept
lemongrass	Concept
Bharata	Entity
Tobaiwa Mudede	Entity
silver	Concept
engram	Concept
Rigveda	Entity
witch-hunt	Concept
Delta Theta Phi	Entity
bug	Concept
cotton flannel	Concept
maple leaf	Concept
Tommy Gavin	Entity
Sino-Japanese War	Entity
senior status	Concept
Tropical Storm Helene	Entity
hearsay rule	Concept
personal check	Concept
Tomb Raider	Entity
coordinator	Concept
Jason Harris	Entity
Susannah York	Entity
elopement	Concept
spats	Concept
estimation	Concept
General Intelligence Directorate	Entity
lousiness	Concept
playlist	Concept
twopence	Concept
dunce cap	Concept
Monaco	Entity
Richard Posner	Entity
passage	Concept
customs	Concept
suer	Concept
Sire Records	Entity
referral	Concept
disposition	Concept
railyard	Concept
Craig Anderson	Entity
triskelion	Concept
freedman	Concept
stability	Concept
Thomas Phillipps	Entity
Yahoo	Entity
dance	Concept
Llaima	Entity
seignior	Concept
fibrillin	Concept
Riverboat Discovery	Entity
bend	Concept
Liege	Entity
close combat	Concept
hurt	Concept
diathermy	Concept
Amis	Concept
citizen	Concept
intransitivity	Concept
Pi Sigma Alpha	Entity
Dirac	Entity
stymy	Concept
lobbyist	Concept
tapir	Concept
committee	Concept
Wicks	Entity
Lars Leksell	Entity
skin	Concept
loot	Concept
lunch	Concept
communization	Concept
Tarawa	Entity
Pindar	Entity
Compact Muon Solenoid	Entity
Phage	Entity
Asia	Entity
Old Oaken Bucket	Entity
Day One	Entity
nuclear power plant	Concept
laptop	Concept
office automation	Concept
cobblestone	Concept
amaretto	Concept
licentiate	Concept
Ronas Hill	Entity
Plymouth	Entity
rose	Concept
Malcolm Wallop	Entity
blacktopping	Concept
Flo Ziegfeld	Entity
Huey Lewis	Entity
newsagent	Concept
protist	Concept
Cradle Will Rock	Entity
threat	Concept
finalization	Concept
podcast	Concept
rubbing alcohol	Concept
floorshow	Concept
Fudan University	Entity
desiccation	Concept
William S. Harney	Entity
Kim Il-sung University	Entity
tableware	Concept
nutrient	Concept
gate	Concept
John Hodiak	Entity
Beatrice	Entity
lipogram	Concept
family therapy	Concept
aileron	Concept
shell	Concept
purplish-red	Concept
chrysoberyl	Concept
quickening	Concept
Tau Kappa Epsilon	Entity
word	Concept
Mitchell Brown	Entity
Ken Russell	Entity
plastic	Concept
footman	Concept
Brady Smith	Entity
tropopause	Concept
Gitta Sereny	Entity
nonage	Concept
certificate	Concept
currency	Concept
form	Concept
slicker	Concept
nationalization	Concept
ley	Concept
strange quark	Concept
law	Concept
generation	Concept
charcoal	Concept
transportation	Concept
Tropical Storm Erika	Entity
gigahertz	Concept
aftermath	Concept
Culebra	Entity
center	Concept
world	Concept
parkway	Concept
flowage	Concept
ball	Concept
RELCOM	Entity
snag	Concept
stomach	Concept
Derbyshire Peak	Entity
Half-Life 2	Entity
gradation	Concept
inertia	Concept
Muppet Babies	Entity
science journalism	Concept
carbon	Concept
Sachs Harbour	Entity
grits	Concept
precognition	Concept
baba	Concept
Harold Volkmer	Entity
wave	Concept
Syria	Entity
demonstration	Concept
counterpane	Concept
hound	Concept
byroad	Concept
rectory	Concept
Hurricane Rita	Entity
inverse distance weighting	Concept
Middle Ages	Entity
agogo	Concept
patchwork	Concept
Dale	Entity
cell death	Concept
softball	Concept
antibody	Concept
computational model	Concept
exercise	Concept
Figurines	Entity
activator	Concept
animosity	Concept
recommendation	Concept
Patrizia Ciofi	Entity
shoe	Concept
Before Dark	Entity
spectroscope	Concept
frond	Concept
abnegation	Concept
Precambrian	Entity
recycling	Concept
misfire	Concept
heptose	Concept
Amsterdam Admirals	Entity
consummation	Concept
franchise	Concept
violin	Concept
Unix shell	Concept
Simon Walker	Entity
jackhammer	Concept
Funen	Entity
insignia	Concept
Denning	Entity
diadem	Concept
Ludwig Boltzmann	Entity
restitution	Concept
steeper	Concept
dhole	Concept
formula	Concept
wood nymph	Concept
downlight	Concept
residence hall	Concept
lightning rod	Concept
épée	Concept
scoutmaster	Concept
trade embargo	Concept
defiance	Concept
Sathyan	Entity
Lido	Entity
Gabriel Guerra	Entity
pension fund	Concept
enlistment	Concept
Soul Train	Entity
babysitting	Concept
validity	Concept
LEGO	Entity
ecology	Concept
retainer	Concept
pafuramidine	Concept
Wisconsin	Entity
newsletter	Concept
engineering	Concept
Collin Peterson	Entity
Port Huron	Entity
Hipparcos	Entity
fess	Concept
vendue	Concept
striatum	Concept
Mollie Katzen	Entity
ideal	Concept
neurologist	Concept
self-justification	Concept
BattleTech	Entity
wage	Concept
Frankenstein	Entity
Fyodor Dostoyevsky	Entity
sparerib	Concept
snatch	Concept
overhead	Concept
tetramethylammonium hydroxide	Concept
tipper	Concept
chromatography	Concept
expedition	Concept
capture	Concept
disc	Concept
microprocessor	Concept
IBC	Entity
organdy	Concept
makeover	Concept
pragmatism	Concept
viniculture	Concept
Robert Solow	Entity
jockey	Concept
commuter rail	Concept
Hero	Entity
homeless	Concept
blackfly	Concept
grid	Concept
roaring	Concept
calumniation	Concept
stetson	Concept
brain	Concept
streptomycin	Concept
scabies	Concept
blockade	Concept
poetry	Concept
mouse	Concept
tomato soup	Concept
male	Concept
Leslie Caron	Entity
sight	Concept
BLAST	Entity
HandBrake	Entity
Kazak	Concept
Stephanian	Entity
pressing	Concept
cutlery	Concept
octillion	Concept
weapon	Concept
John Edward Taylor	Entity
overall	Concept
Pauli	Entity
Howard Davis	Entity
lithium	Concept
flak	Concept
louse	Concept
Unreal Engine	Entity
kidney transplantation	Concept
Gunther Gebel-Williams	Entity
life history	Concept
course	Concept
accreditation	Concept
Joseph Rodman Drake	Entity
subsidy	Concept
coxswain	Concept
Greg Germann	Entity
euphemism	Concept
French Broad River	Entity
chauvinism	Concept
cornstarch	Concept
Woolsack	Entity
dirham	Concept
reminiscence	Concept
Cooperation and Development	Entity
circuit	Concept
luffa	Concept
first lady	Concept
warming	Concept
Valley Girls	Entity
tadpole	Concept
spring	Concept
throw	Concept
volcanology	Concept
accelerator	Concept
denial-of-service attack	Concept
SIMION	Entity
Nohar	Entity
Post	Entity
dike	Concept
spokesman	Concept
miscreant	Concept
Linum	Concept
doeskin	Concept
horsehair	Concept
working capital	Concept
wheeler	Concept
coalition	Concept
epistemology	Concept
Frank Henry	Entity
clopyralid	Concept
Henry Allan	Entity
hydrosphere	Concept
Olivia de Havilland	Entity
topping	Concept
nude	Concept
racoon	Concept
leishmaniasis	Concept
report	Concept
observation	Concept
noun	Concept
sustainable tourism	Concept
letter	Concept
Bealeton	Entity
satoyama	Concept
sitagliptin	Concept
color constancy	Concept
grass	Concept
flag	Concept
roomette	Concept
