Tau Kappa Epsilon	Entity
rotter	Concept
aerofoil	Concept
Bob Beers	Entity
Chef Menteur Pass	Entity
nonverbal communication	Concept
Before Dark	Entity
kinetic theory	Concept
general assembly	Concept
great-grandfather	Concept
German mark	Concept
perry	Concept
climate	Concept
nuclear power plant	Concept
Planck	Entity
Showroom	Concept
oat	Concept
Mark Tully	Entity
health facility	Concept
doeskin	Concept
yaupon holly	Concept
Aram I	Entity
bulk	Concept
device	Concept
script	Concept
learner	Concept
fading	Concept
pigweed	Concept
parameter	Concept
invalid	Concept
pollution	Concept
hovel	Concept
deregulating	Concept
Soul Train	Entity
Dionysia	Concept
flocculation	Concept
court	Concept
Devonian	Entity
birdwatching	Concept
Semipalatinsk Test Site	Entity
Joseph Rodman Drake	Entity
wood nymph	Concept
Emmett Tyrrell	Entity
tectonics	Concept
compound	Concept
Verlot	Entity
stepper	Concept
gusset	Concept
sandbox	Concept
afterlife	Concept
racial profiling	Concept
disc	Concept
scallywag	Concept
teacher	Concept
nu metal	Concept
Danish Kaneria	Entity
oil pollution	Concept
fund	Concept
smut	Concept
chest of drawers	Concept
close combat	Concept
one-way street	Concept
shawl	Concept
degree	Concept
bank	Concept
ultramicroscope	Concept
TV	Concept
sight	Concept
ridge	Concept
offensive	Concept
POB	Concept
Mister Johnson	Entity
character	Concept
bye-election	Concept
lofepramine	Concept
squall line	Concept
solid	Concept
Patrizia Ciofi	Entity
academician	Concept
storm	Concept
fine	Concept
accreditation	Concept
pumpkin	Concept
Jump Cut	Entity
Tim Dwight	Entity
multimeter	Concept
Jerry Oltion	Entity
nutrition	Concept
bladder cancer	Concept
flag	Concept
Nuptse	Entity
Canyonlands	Entity
respiratory disease	Concept
Messi	Entity
Tom Hanks	Entity
ironing	Concept
Joan Silber	Entity
Edward Weston	Entity
calcium	Concept
Richard Kuklinski	Entity
escheat	Concept
pool	Concept
wetsuit	Concept
babysitting	Concept
Skara Brae	Entity
Manassas	Entity
giro	Concept
camera	Concept
clerisy	Concept
Half-Life 2	Entity
leishmaniasis	Concept
artemisia	Concept
spile	Concept
brittle	Concept
Haven	Entity
restaurant	Concept
Bomberman	Entity
prince	Concept
autograph	Concept
mother	Concept
Zhao Ziyang	Entity
Deutschland	Entity
engineering	Concept
Willamette University	Entity
overhead	Concept
lipstick	Concept
Cradle Will Rock	Entity
torsion	Concept
newsprint	Concept
IBC	Entity
fibrillin	Concept
eponychium	Concept
festival	Concept
tadpole	Concept
William Corson	Entity
Taiwan Relations Act	Entity
Constantius	Entity
Seekonk	Entity
inheritance	Concept
poet	Concept
Suzy Favor Hamilton	Entity
stationmaster	Concept
curling	Concept
payoff	Concept
Apiaceae	Concept
gray	Concept
Jimmy Tingle	Entity
precision	Concept
Sonoma State University	Entity
John Livingston	Entity
granularity	Concept
in-joke	Concept
white coat	Concept
Manage	Entity
sunshine	Concept
washing	Concept
Cecilia	Entity
whoredom	Concept
graduate	Concept
St. Augustine	Entity
camellia	Concept
leaf curl	Concept
award	Concept
Cymru	Entity
Blithe Spirit	Entity
board	Concept
cox	Concept
magnetic dipole	Concept
dance	Concept
country	Concept
Frederick Sanger	Entity
stem-cell research	Concept
dwarf planet	Concept
tableware	Concept
Fort Klamath	Entity
trust company	Concept
SpamBayes	Entity
Slovenia	Entity
recall	Concept
soil pipe	Concept
Newdale	Entity
Don Baldwin	Entity
Fort Meade	Entity
John Edward Taylor	Entity
reporter	Concept
American Stock Exchange	Entity
triskelion	Concept
breve	Concept
hair	Concept
space research	Concept
lie detector	Concept
heptose	Concept
faulting	Concept
lira	Concept
Battersea Arts Centre	Entity
leger	Concept
public service	Concept
Collin Peterson	Entity
Amsterdam Internet Exchange	Entity
serfdom	Concept
John Barclay	Entity
newsagent	Concept
outfit	Concept
loom	Concept
evolutionary biologist	Concept
nag	Concept
mail	Concept
John Franks	Entity
coal	Concept
Kansas	Entity
sun	Entity
employee	Concept
Tobaiwa Mudede	Entity
BattleTech	Entity
customs	Concept
lag	Concept
Hudson	Entity
archduke	Concept
Breidenbach	Entity
Saint Anna	Entity
Hermes	Entity
walk	Concept
Larderello	Entity
Myrdal	Entity
Indonesia	Entity
Mary McCarthy	Entity
filial piety	Concept
shock	Concept
autonomous region	Concept
groceries	Concept
voltage divider	Concept
hardpan	Concept
Yahoo	Entity
tartar	Concept
hyperlink	Concept
HMAS Perth	Entity
spell	Concept
horsehair	Concept
Fourth World	Entity
Malvolio	Entity
imperialism	Concept
SIMION	Entity
space	Concept
Carlos Tosca	Entity
Modest Mouse	Entity
Mohammed	Entity
human rights	Concept
sanctuary	Concept
valuation	Concept
activator	Concept
nonsmoker	Concept
Hamlet	Entity
Lugh	Entity
conviction	Concept
State Highway 12	Entity
island	Concept
supermajority	Concept
chaff	Concept
chapter	Concept
alb	Concept
seaquake	Concept
shelter	Concept
polysemy	Concept
viola	Concept
radon	Concept
jerky	Concept
Mollie Katzen	Entity
prerogative	Concept
Valley Girls	Entity
detour	Concept
Sandy Mitchell	Entity
res judicata	Concept
New Zealand	Entity
Coinage Act	Entity
headshot	Concept
stonecutter	Concept
ozone	Concept
couture	Concept
White House	Entity
warlord	Concept
Hurricane Iniki	Entity
variety	Concept
Kingdom Hospital	Entity
lanugo	Concept
swashbuckler	Concept
antibody	Concept
hunting	Concept
Helen of Troy	Entity
turn	Concept
greywacke	Concept
junkware	Concept
Riptide	Entity
insight	Concept
violin	Concept
silhouette	Concept
tendentiousness	Concept
Turistas	Entity
coupling	Concept
disengagement	Concept
Beijing	Entity
covenant	Concept
Roald Amundsen	Entity
horsepower	Concept
gerontocracy	Concept
Qarbon	Entity
Leslie Caron	Entity
tactic	Concept
Nyahururu	Entity
Sathyan	Entity
Zimbabwean	Concept
alumnus	Concept
threat	Concept
laptop	Concept
eisteddfod	Concept
Winston S. Churchill	Entity
doodlebug	Concept
Sergei Shamba	Entity
questionnaire	Concept
green roof	Concept
trust	Concept
tubing	Concept
cotton candy	Concept
puzzler	Concept
potato	Concept
sacrifice	Concept
I-20	Entity
quietness	Concept
carbon	Concept
Chromehounds	Entity
fire service	Concept
breakfast	Concept
mountain	Concept
handshake	Concept
bell-bottoms	Concept
single tax	Concept
fertility rate	Concept
harasser	Concept
driving	Concept
Mixtec	Entity
gannet	Concept
dirt	Concept
Nubian	Concept
mould	Concept
John Munroe	Entity
blueness	Concept
John Romer	Entity
L.A. Confidential	Entity
accolade	Concept
Zinc	Entity
Milton Shapp	Entity
Ubu Roi	Entity
fess	Concept
Erna Brodber	Entity
chronic	Concept
pressing	Concept
dean	Concept
Beatties	Entity
Jackie Mittoo	Entity
Antony Leung	Entity
D'Arcy Wentworth	Entity
cancer	Concept
Typhoon Saomai	Entity
lustiness	Concept
patient	Concept
Charles Alexander	Entity
covering	Concept
portraitist	Concept
bread	Concept
Stardock	Entity
docker	Concept
links	Concept
ruby	Concept
conversion	Concept
avulsion	Concept
anglophile	Concept
Robert Boyle	Entity
singlet	Concept
Bevis Hillier	Entity
Federal Records	Entity
flooding	Concept
Irish	Entity
pawnbroker	Concept
house	Concept
rejection	Concept
terawatt	Concept
sarcophagus	Concept
Preston Manning	Entity
casserole	Concept
Bennington	Entity
Eteocles	Entity
Valeria Golino	Entity
Arapaho	Entity
Blindsight	Entity
crisis	Concept
Norfolk	Entity
wing	Concept
preparation	Concept
pusher	Concept
coxswain	Concept
desiccation	Concept
charcoal	Concept
surf	Concept
jammies	Concept
moderator	Concept
Inland Revenue	Concept
machine	Concept
dicky	Concept
joystick	Concept
florin	Concept
hearsay rule	Concept
prexy	Concept
Wii	Entity
selector	Concept
queenfish	Concept
Fruitlands	Entity
convertibility	Concept
plumbing	Concept
Sire Records	Entity
tebuconazole	Concept
Bob Broeg	Entity
Jane Clifton	Entity
apple pie	Concept
lyceum	Concept
baguette	Concept
affectionateness	Concept
bloodguilt	Concept
fish	Concept
outlaw	Concept
library	Concept
chai tea	Concept
militarization	Concept
Frank Henry	Entity
earphones	Concept
The New Republic	Entity
satoyama	Concept
August	Concept
Walter Boyce	Entity
prayer	Concept
Bill Pullman	Entity
Hansel	Entity
University of Liverpool	Entity
Swimclub	Entity
record label	Concept
disposition	Concept
magnetic storage	Concept
parents	Concept
militia	Concept
Talcott Parsons	Entity
instrumental	Concept
hurt	Concept
pinny	Concept
This Love	Entity
proton pump	Concept
facilitator	Concept
shooter	Concept
bear	Concept
wand	Concept
Hypnerotomachia Poliphili	Entity
chateau	Concept
diversity	Concept
horse	Concept
tussle	Concept
steward	Concept
devotion	Concept
gamboge	Concept
elopement	Concept
W. Browning	Entity
Burger King	Entity
Salang Tunnel	Entity
eversion	Concept
firm	Concept
delay	Concept
Figurines	Entity
lemongrass	Concept
outfielder	Concept
baby tears	Concept
banyan	Concept
ethanal	Concept
society	Concept
Arthur Ashe	Entity
inverse distance weighting	Concept
downtime	Concept
petition	Concept
thermoregulation	Concept
marriage	Concept
full stop	Concept
pocketbook	Concept
blockade	Concept
voyager	Concept
station	Concept
spending	Concept
line of duty	Concept
religion	Concept
outreach	Concept
till	Concept
swamp gum	Concept
melanocyte	Concept
Buchenwald	Entity
song thrush	Concept
Turkey	Entity
homophone	Concept
Greccio	Entity
milkwort	Concept
Dorothea Puente	Entity
James Sallis	Entity
sweetness	Concept
product	Concept
staginess	Concept
seal	Concept
woofer	Concept
notion	Concept
Aare	Entity
Cherie Nowlan	Entity
fox	Concept
spotting	Concept
Laksar	Entity
prairie cordgrass	Concept
foster-child	Concept
Bronze Horseman	Entity
boatlift	Concept
Bryher	Entity
hurdling	Concept
knight-errant	Concept
Texas	Entity
guerilla	Concept
Matt Dean	Entity
lynching	Concept
Anthony Hopkins	Entity
rabidity	Concept
Save Mart Center	Entity
burning	Concept
Margaret Robinson	Entity
chronicler	Concept
strappado	Concept
sugar-cane	Concept
Ron Donagi	Entity
great-grandmother	Concept
grapevine	Concept
Ph.D.	Concept
Day One	Entity
complicatedness	Concept
Leipzig	Entity
chuck steak	Concept
sailing ship	Concept
GuideStar	Entity
sub-interval	Concept
studio	Concept
syllabication	Concept
Stanford	Entity
Straight River	Entity
note	Concept
Rheal Cormier	Entity
European Parliament	Entity
classifier	Concept
growth	Concept
junk	Concept
workstation	Concept
foolishness	Concept
cotton flannel	Concept
spats	Concept
diploma	Concept
excommunication	Concept
Kew Palace	Entity
dub	Concept
ghee	Concept
school building	Concept
frequence	Concept
matchlock	Concept
color	Concept
chips	Concept
color constancy	Concept
Wakashan	Concept
Sigma Lambda Beta	Entity
lens	Concept
pill	Concept
Alex Sink	Entity
spectroscope	Concept
Rudolf Arnheim	Entity
proof	Concept
Helene Deutsch	Entity
Lake District	Entity
ewe	Concept
savoy	Concept
Oor Wullie	Entity
salamander	Concept
Culebra	Entity
Wang Xiaolong	Entity
Alexandre Gustave Eiffel	Entity
radish	Concept
rappel	Concept
Dara Horn	Entity
rheumatism	Concept
civil union	Concept
belt	Concept
windage	Concept
slating	Concept
release notes	Concept
Kirk Fordice	Entity
world	Concept
microprocessor	Concept
child care	Concept
transmission	Concept
preaching	Concept
snooze	Concept
PricewaterhouseCoopers	Entity
amaretto	Concept
Ansel Adams	Entity
Wolfe	Entity
John Pankow	Entity
praise	Concept
HandBrake	Entity
meningitis	Concept
Feral Interactive	Entity
animosity	Concept
Susannah Heschel	Entity
diner	Concept
teamster	Concept
proprioception	Concept
secular	Concept
Ian Bell	Entity
paprika	Concept
arboriculture	Concept
Standerton	Entity
Ken Russell	Entity
dual carriageway	Concept
label	Concept
gluon	Concept
coordinator	Concept
domain	Concept
triumvirate	Concept
truth	Concept
potassium iodide	Concept
XML	Entity
impromptu	Concept
Surjit Singh Barnala	Entity
contribution	Concept
Mota	Entity
Jimmy Stewart	Entity
assist	Concept
phone call	Concept
sunspot	Concept
baronet	Concept
blind	Concept
pearl	Concept
anycast	Concept
foreshadowing	Concept
confederacy	Concept
Dublin Bus	Entity
Bradgate Park	Entity
crosswind	Concept
Jemison	Entity
RVF	Concept
planetary science	Concept
Tennessee	Entity
preserve	Concept
small	Concept
money	Concept
glen	Concept
vice president	Concept
real world	Concept
Maxims	Entity
Alec Stewart	Entity
observance	Concept
RF modulator	Concept
Vorukh	Entity
endarteritis	Concept
capillary	Concept
Martha Blount	Entity
sliminess	Concept
top side	Concept
tacking	Concept
flood	Concept
South Kensington	Entity
Tropical Storm Cindy	Entity
song	Concept
Palazzo Farnese	Entity
bed rest	Concept
gateway	Concept
proteolysis	Concept
steeper	Concept
Roy Hattersley	Entity
die	Concept
back porch	Concept
budget	Concept
stetson	Concept
manslaughter	Concept
dollar	Concept
Thomas Phillipps	Entity
roaring	Concept
shellac	Concept
Caligula	Entity
consummation	Concept
tax haven	Concept
Johnny Ramone	Entity
Neon Genesis Evangelion	Entity
blindfold	Concept
plantation	Concept
transport	Concept
James Kirchick	Entity
Phil Silvers	Entity
psychokinesis	Concept
pod	Concept
adobe	Concept
cesarean delivery	Concept
business concern	Concept
hybrid	Concept
Bear Creek	Entity
Typhoon Lupit	Entity
yawl	Concept
Transantarctic Mountains	Entity
Hurricane Fabian	Entity
Yapese	Concept
jackhammer	Concept
Crowds and Power	Entity
scabies	Concept
Gerry Davis	Entity
hockey	Concept
Catscratch	Entity
cookhouse	Concept
boundary	Concept
natural gas	Concept
relative price	Concept
granadilla	Concept
video	Concept
Bill Koski	Entity
eudaimonia	Concept
teleportation	Concept
Tarawa	Entity
wallop	Concept
maverick	Concept
liquidation	Concept
Ceuta	Entity
disincentive	Concept
kid	Concept
Gunther Gebel-Williams	Entity
Jim Beach	Entity
Jonathan Freedland	Entity
zero	Concept
greenmail	Concept
Java	Entity
avenue	Concept
closeness	Concept
Emmeline Pankhurst	Entity
henbit	Concept
Mount St. Helens	Entity
Mel Gibson	Entity
Giovanni Bellini	Entity
Josef Gingold	Entity
bean	Concept
Murder One	Entity
Visual FoxPro	Entity
Mario Kart DS	Entity
shogunate	Concept
Anna Lindh	Entity
economic growth	Concept
ecclesiastic	Concept
James Hogg	Entity
running	Concept
Animorphs	Entity
Chevrolet SSR	Entity
freight	Concept
Red Planet	Entity
column	Concept
Achille	Entity
AI	Concept
certified check	Concept
coffee	Concept
autocracy	Concept
Israel	Entity
Lancashire	Entity
timidness	Concept
Old Oaken Bucket	Entity
Linum	Concept
Scott Styris	Entity
pipe	Concept
Nahum Sonenberg	Entity
strangulation	Concept
Barney Bigard	Entity
compact disc	Concept
advancement	Concept
ensign	Concept
offense	Concept
czar	Concept
student council	Concept
isolationism	Concept
Mariamman	Entity
supernaturalism	Concept
wave	Concept
heedfulness	Concept
Nara	Entity
observation	Concept
arbitrage	Concept
Wiktionary	Entity
Graduate House	Entity
Mitchell Brown	Entity
blank	Concept
White Star	Entity
spinal fusion	Concept
Highlander	Entity
Thanatos	Entity
retribution	Concept
success	Concept
anapsid	Concept
Bingley	Entity
witness	Concept
outflow	Concept
Unreal Engine	Entity
spelt	Concept
Kathryn Werdegar	Entity
Muppet Babies	Entity
Chuck Schumer	Entity
center	Concept
medical care	Concept
sou	Concept
clopyralid	Concept
article	Concept
landgrave	Concept
heller	Concept
fuse	Concept
megathrust earthquake	Concept
make	Concept
Evgeny Kissin	Entity
Jane Elliott	Entity
actor	Concept
Jack Trout	Entity
Bashi Channel	Entity
yesterday	Concept
Timothy Leary	Entity
Zhu Di	Entity
bibliographic database	Concept
Dairen	Entity
conscience	Concept
Knoxville	Entity
Fahrenheit	Entity
vigabatrin	Concept
distributer	Concept
orison	Concept
longbow	Concept
palm	Concept
Castlereagh River	Entity
sculpture	Concept
Kenai Peninsula	Entity
capital	Concept
matador	Concept
poundage	Concept
loser	Concept
Archaean	Entity
baronetcy	Concept
zabaglione	Concept
Turonian	Entity
tapis	Concept
residence time	Concept
Neil Gillman	Entity
agogo	Concept
way out	Concept
WSRP	Entity
interdict	Concept
journal	Concept
riptide	Concept
Washburn High School	Entity
clastic	Concept
Internet	Concept
Durham	Entity
quarry	Concept
beam	Concept
hound	Concept
throw	Concept
hostile fire	Concept
synthesis	Concept
Pindar	Entity
Maryland	Entity
diadem	Concept
Merriam-Webster	Entity
power point	Concept
gradation	Concept
Whitaker	Entity
mongoose	Concept
acquiescence	Concept
sod	Concept
blastomere	Concept
issuer	Concept
editorial	Concept
cooking ingredient	Concept
price of admission	Concept
madam	Concept
Susanna Clarke	Entity
Chris Phillips	Entity
disservice	Concept
Harmonia axyridis	Concept
gasworks	Concept
TimeShift	Entity
revetment	Concept
dexterity	Concept
Jean Piaget	Entity
release	Concept
blame	Concept
Timeless	Entity
emptiness	Concept
Will Cotton	Entity
Republic of Turkey	Entity
viceroy	Concept
star	Concept
macroeconomics	Concept
Ronas Hill	Entity
Lars Leksell	Entity
John Fitzgerald Kennedy	Entity
Turtle Mountains	Entity
wood	Concept
defeat	Concept
purplish-red	Concept
Epistles	Entity
Oakland City Hall	Entity
engine	Concept
flattop	Concept
convert	Concept
noble	Concept
H-Net	Entity
skin	Concept
styrofoam	Concept
history of science	Concept
Leonidas	Entity
James Mason	Entity
webmail	Concept
list	Concept
light pollution	Concept
coda	Concept
Equator	Entity
inquisitor	Concept
CISC	Concept
aerodrome	Concept
packet filtering	Concept
catchment area	Concept
phonetic transcription	Concept
minors	Concept
Anthony Caro	Entity
feebleness	Concept
Mokelumne Wilderness	Entity
glottal stop	Concept
Slax	Entity
counterclaim	Concept
overflow	Concept
Nathan Lane	Entity
vindication	Concept
heritage	Concept
promulgation	Concept
confederation	Concept
commuter rail	Concept
USS Housatonic	Entity
cascade	Concept
nude	Concept
breechcloth	Concept
net	Concept
Sam Browne	Entity
compiler	Concept
first lady	Concept
Harold W. Dodds	Entity
rabble-rouser	Concept
viral marketing	Concept
Exodus	Entity
pula	Concept
attempt	Concept
sport	Concept
pseudogout	Concept
Grani	Entity
bug	Concept
Earthsea	Entity
Tropical Storm Helene	Entity
Denning	Entity
Cherryholmes	Entity
failure rate	Concept
curriculum	Concept
consigner	Concept
slicker	Concept
emery cloth	Concept
page	Concept
shortsightedness	Concept
Deep learning	Concept
piastre	Concept
California State University	Entity
camelpox	Concept
gate	Concept
bulkhead	Concept
Bowhead whale	Concept
chowder	Concept
tornado	Concept
Hurricane Epsilon	Entity
UN	Entity
ultranationalism	Concept
honorable discharge	Concept
tortilla chip	Concept
Adams Express Company	Entity
antagonism	Concept
Russell Shorto	Entity
Margot Fonteyn	Entity
La Veta Pass	Entity
kingdom	Concept
duke	Concept
global warming	Concept
enrollee	Concept
El Mercurio	Entity
edger	Concept
chauvinism	Concept
Drawing Restraint 9	Entity
pontiff	Concept
Jeremy Nathans	Entity
Young	Entity
disk	Concept
Indians	Entity
giantess	Concept
headquarters	Concept
computational model	Concept
HDP	Entity
source	Concept
proposal	Concept
rotunda	Concept
Gabriel Guerra	Entity
aircraft	Concept
adventure	Concept
Ieuaf	Entity
staphylococci	Concept
metropolitan area	Concept
striatum	Concept
authoress	Concept
brute	Concept
nitrification	Concept
army	Concept
shtup	Concept
snag	Concept
Leonardo da Vinci	Entity
Liege	Entity
volcanology	Concept
Otto Lilienthal	Entity
Nohar	Entity
William Cowper	Entity
accessibility	Concept
Jeff Francis	Entity
veratrum	Concept
Ape Escape	Entity
downlight	Concept
validity	Concept
Dance Mix	Entity
Phoebe Buffay	Entity
journalist	Concept
octillion	Concept
Touch and Go	Entity
AltiVec	Entity
prime minister	Concept
Eliezer Yudkowsky	Entity
Paul Mellars	Entity
Sonora	Entity
escutcheon	Concept
passage	Concept
cent	Concept
coma	Concept
manufacturing	Concept
Catoctin Mountain Park	Entity
molecule	Concept
Andrew Anderson	Entity
protist	Concept
Susannah York	Entity
diabetic nephropathy	Concept
Hill cipher	Concept
regulating	Concept
New Orleans	Entity
Derbyshire Peak	Entity
annals	Concept
Ada Comstock	Entity
Malcolm Wallop	Entity
Marjorie Garber	Entity
Harold Volkmer	Entity
sport shirt	Concept
Hipparcos	Entity
gorget	Concept
turquoise	Concept
computer industry	Concept
barley	Concept
Richard Starkey	Entity
playwriting	Concept
chestnut	Concept
specular reflection	Concept
paraffin	Concept
cell death	Concept
Prentice Hall	Entity
OpenOffice.org	Entity
mark	Concept
hypostasis	Concept
reading teacher	Concept
Vera Nazarian	Entity
Elbridge Gerry	Entity
Augustine Volcano	Entity
Gerrard Winstanley	Entity
Mike Allen	Entity
Fast Company	Entity
guard	Concept
subsoil	Concept
vision	Concept
minister	Concept
tomato soup	Concept
dormouse	Concept
surprise	Concept
jug	Concept
executive vice president	Concept
Henry Allan	Entity
binder	Concept
Campo San Polo	Entity
family therapy	Concept
prescription	Concept
science journalism	Concept
Caddoan	Concept
Prowler	Entity
suspension	Concept
Rell Sunn	Entity
complaint	Concept
tricolour	Concept
San Andreas	Entity
potter	Concept
adult	Concept
exposition	Concept
delta	Concept
academic year	Concept
Tropical Storm Erika	Entity
greensand	Concept
The Infinite Mind	Entity
balance of power	Concept
grit	Concept
club	Concept
delegacy	Concept
warfare	Concept
conglomerate	Concept
Siegfried Sassoon	Entity
Sajid Mahmood	Entity
needlepoint	Concept
Battlestar Galactica	Entity
representative	Concept
samurai	Concept
shamrock	Concept
Simon Walker	Entity
hooded cloak	Concept
Michelle Thomas	Entity
ground level	Concept
coalition	Concept
Transportation	Entity
director	Concept
stairway	Concept
Grigori Perelman	Entity
Tutankhamun	Entity
lunch	Concept
escudo	Concept
short-term memory	Concept
veranda	Concept
committee	Concept
advocacy	Concept
Venus	Entity
male	Concept
turnstile	Concept
trade	Concept
Sidney R. Yates	Entity
cocktail	Concept
totient	Concept
dress	Concept
octopus	Concept
mouse	Concept
grandee	Concept
open proxy server	Concept
hornist	Concept
poetry	Concept
atomizer	Concept
environment	Concept
breeze	Concept
wrestler	Concept
hakim	Concept
Wicks	Entity
prepositional phrase	Concept
magnet	Concept
extramarital sex	Concept
fosterling	Concept
patrician	Concept
Roos	Entity
drug of abuse	Concept
homeless	Concept
lion	Concept
word	Concept
Long Tack Sam	Entity
Griselda	Entity
Marcel Duchamp	Entity
episode	Concept
heaven	Concept
witchery	Concept
Swarthmore	Entity
Cromford Canal	Entity
credit	Concept
bioenergy	Concept
cabin	Concept
diffraction	Concept
Vat Phou	Entity
netherworld	Concept
pragmatics	Concept
Narragansett Bay	Entity
schoolwork	Concept
redundancy check	Concept
skeet shooting	Concept
Juan Cole	Entity
sapphire	Concept
search engine	Concept
quickening	Concept
Dorion Sagan	Entity
lysine	Concept
demonstration	Concept
website	Concept
precognition	Concept
defiance	Concept
Verrier Elwin	Entity
life history	Concept
ten thousand	Concept
Louisiana	Entity
binge	Concept
Scott City	Entity
Frank Harris	Entity
literature	Concept
Austin	Entity
LEGO	Entity
groundnut	Concept
oriflamme	Concept
bird sanctuary	Concept
slump	Concept
Hillbrow	Entity
relay	Concept
certificate	Concept
inspection	Concept
Susan Strasberg	Entity
Leon Festinger	Entity
flow	Concept
warming	Concept
Trimble	Entity
sodium nitrite	Concept
licentiate	Concept
French	Entity
philia	Concept
Neumont University	Entity
soul mate	Concept
Pinot blanc	Concept
Uraniborg	Entity
ergotamine	Concept
synchronizer	Concept
Tony Malaby	Entity
vivisection	Concept
possession	Concept
mechanics	Concept
waiver	Concept
Larry Niven	Entity
Wilma Vaught	Entity
palisade	Concept
termination	Concept
royalist	Concept
chromatography	Concept
law	Concept
flak	Concept
overpass	Concept
subject	Concept
Flo Ziegfeld	Entity
quinine	Concept
footway	Concept
Pauli	Entity
tortilla	Concept
Europe	Entity
ringtone	Concept
village hall	Concept
river	Concept
Bharata	Entity
East Capitol Street	Entity
smallpox virus	Concept
capsule	Concept
carting	Concept
stilt	Concept
mycelium	Concept
Misti	Entity
Hany Farid	Entity
petty officer	Concept
Lander University	Entity
Sake	Entity
burr oak	Concept
font	Concept
Stephanian	Entity
Joyce	Entity
tropopause	Concept
golden rule	Concept
Photek	Entity
Cyprus	Entity
liberalism	Concept
paragraph	Concept
thread	Concept
emperor	Concept
deserter	Concept
Amis	Concept
laser	Concept
digester	Concept
thiocyanate	Concept
atmosphere	Concept
square sail	Concept
Aryabhata	Entity
elimination	Concept
oculist	Concept
City of Whitehorse	Entity
electron microscopy	Concept
fence	Concept
Howard K. Smith	Entity
service	Concept
Half-Life	Entity
The Washington Post	Entity
macadam	Concept
pragmatism	Concept
Tulsa World	Entity
Micronesia	Entity
hosiery	Concept
John Drew	Entity
ball	Concept
triple	Concept
Fort Sumter	Entity
Walter Gropius	Entity
Ellida	Concept
air mass	Concept
immunologist	Concept
pension	Concept
Isaiah	Entity
shipping	Concept
Edmund Burke	Entity
roundhouse	Concept
explosion	Concept
sigma	Concept
brain	Concept
Maginot	Entity
Auguste Rodin	Entity
Bill Douglass	Entity
bartlett	Concept
Bill Clinton	Entity
Maximum Carnage	Entity
catechumen	Concept
empire	Concept
blackfly	Concept
Z1	Entity
Adobe Flash Lite	Entity
influenza	Concept
Brookline	Entity
assignment	Concept
capability	Concept
Giovanni da Verrazzano	Entity
Montlake Bridge	Entity
ounce	Concept
Winterthur	Entity
seminar	Concept
nonage	Concept
S4	Concept
Tulsa	Entity
potato salad	Concept
Phage	Entity
surd	Concept
sister	Concept
picture	Concept
highschool	Concept
Parveen Babi	Entity
About.com	Entity
jingoism	Concept
neurologist	Concept
sapote	Concept
wire	Concept
Voyager 1	Entity
stack	Concept
pension fund	Concept
hegemony	Concept
crab	Concept
Myers-Briggs Type Indicator	Entity
farmer	Concept
warship	Concept
botany	Concept
Josh Willis	Entity
jeopardy	Concept
crumpet	Concept
decaf	Concept
euphemism	Concept
commoner	Concept
grounds	Concept
University of California	Entity
baptismal font	Concept
immateriality	Concept
penal colony	Concept
exponent	Concept
sphinx	Concept
Nina Pacari	Entity
pennon	Concept
register	Concept
emulator	Concept
headmaster	Concept
balsam	Concept
mask	Concept
arms	Concept
Niels Bohr	Entity
integration	Concept
marquee	Concept
flirting	Concept
Rigveda	Entity
visibility	Concept
Philip Durell	Entity
dhow	Concept
contrast agent	Concept
cingulate gyrus	Concept
West Midlands	Entity
water balloon	Concept
sustainability	Concept
Urbana University	Entity
tragedy	Concept
platform	Concept
lats	Concept
derogation	Concept
city wall	Concept
citizen	Concept
Nancy	Entity
Franco Corelli	Entity
stymy	Concept
Fyodor Dostoyevsky	Entity
Ohio	Entity
Kohler	Entity
HP	Entity
Deck	Concept
World War II	Entity
eternity	Concept
beacon	Concept
mode	Concept
guest house	Concept
copper	Concept
pe	Concept
handful	Concept
hauling	Concept
Omiya	Entity
vigour	Concept
tempestuousness	Concept
scouter	Concept
Prentiss	Entity
Olivia de Havilland	Entity
Younger Dryas	Entity
acanthocephalan	Concept
Comfortably Numb	Entity
DirectX	Entity
dirham	Concept
Beowulf	Entity
seafloor	Concept
interface	Concept
Reconnaissance Battalion	Entity
Monster Magnet	Entity
priority	Concept
BLAST	Entity
Bergen	Entity
sparerib	Concept
Marienkirche	Entity
disciple	Concept
Belt Line	Entity
estimation	Concept
admittance	Concept
George Soros	Entity
owner	Concept
animation	Concept
cosmic dust	Concept
playlist	Concept
horizontal bar	Concept
Essex	Entity
Mjolnir	Entity
quo warranto	Concept
monzonite	Concept
dunce cap	Concept
IRA	Concept
lipogram	Concept
kingbird	Concept
Pope Pius X	Entity
ruling	Concept
flowage	Concept
eschaton	Concept
bird	Concept
tropical storm	Concept
festivity	Concept
racoon	Concept
radical feminism	Concept
Eric Becklin	Entity
charity	Concept
Aaron Copland	Entity
Albuquerque	Entity
sidestroke	Concept
policy	Concept
police	Concept
20th century	Concept
mill	Concept
Lido	Entity
keyboardist	Concept
postdoc	Concept
transportation	Concept
winner	Concept
Samuel Johnson	Entity
Jon Clardy	Entity
tipper	Concept
fresco	Concept
palette	Concept
aileron	Concept
