Björk	Entity
old-time country	Concept
ethnic music	Concept
Fugazi	Entity
Paint It Black	Entity
transition	Concept
light opera	Concept
Frank Sinatra	Entity
Public Enemy	Entity
gittern	Concept
national anthem	Concept
Planet Earth	Entity
scottish folk	Concept
love song	Concept
Carl Davis	Entity
electric blues	Concept
southern rock	Concept
drumstick	Concept
playback	Concept
doo wop	Concept
bass saxophone	Concept
vocalizing	Concept
sing-a-longs	Concept
guitar	Concept
Seraphim	Entity
score	Concept
southern rap	Concept
twee pop	Concept
tenor tuba	Concept
classical music	Concept
harmonica	Concept
salsa	Concept
The Rolling Stones	Entity
soundtrack	Concept
mandolin	Concept
minstrelsy	Concept
rainstick	Concept
disco	Concept
piano music	Concept
Salad Days	Entity
american punk	Concept
jamaican ska	Concept
foreword	Concept
kalimba	Concept
Calloway	Entity
habanera	Concept
heavy metal	Concept
Nine Inch Nails	Entity
british punk	Concept
rhumba	Concept
potpourri	Concept
lieder	Concept
steel drums	Concept
Beastie Boys	Entity
experimental rap	Concept
shred	Concept
vamp	Concept
neo-soul	Concept
blues	Concept
Russian pop	Concept
Chamberlin	Entity
New Order	Entity
Katy Perry	Entity
Charlotte Church	Entity
serialism	Concept
Kenny Loggins	Entity
carol	Concept
latin music	Concept
sea chantey	Concept
Electric guitar	Concept
gregorian chant	Concept
pavan	Concept
golden oldie	Concept
viola	Concept
castanets	Concept
The Velvet Underground	Entity
Stream of Consciousness	Entity
drum & bass	Concept
alternative metal	Concept
pastoral	Concept
texas blues	Concept
krautrock	Concept
Stronger	Entity
rondeau	Concept
guitar gods	Concept
classical	Concept
Iris	Entity
Heart Food	Entity
concert grand piano	Concept
gong	Concept
military march	Concept
rap	Concept
swedish pop	Concept
concertos	Concept
cadence	Concept
threnody	Concept
pastiche	Concept
Judas Priest	Entity
tenor	Concept
orchestra	Concept
divertimento	Concept
plainchant	Concept
ostinato	Concept
soft rock	Concept
surf guitar	Concept
Taiwanese pop	Concept
Mike Hickey	Entity
rock-and-roll	Concept
jump blues	Concept
Good Vibrations	Entity
Live Forever	Entity
gavotte	Concept
Phil Collins	Entity
electronic	Concept
preface	Concept
variation	Concept
Mayhem	Entity
wedding music	Concept
Dance-rock	Concept
prologue	Concept
ska	Concept
David Foster	Entity
The Prodigy	Entity
contrabassoon	Concept
Zeraphine	Entity
west coast	Concept
counterpoint	Concept
güiro	Concept
chanson	Concept
invention	Concept
glam rock	Concept
Frank Zappa	Entity
pop metal	Concept
sonata	Concept
track	Concept
big beat	Concept
drums	Concept
punk	Concept
dance pop	Concept
Space Monkeys	Entity
idm	Concept
anthem	Concept
Tony Brock	Entity
oldies	Concept
Kazimierz Serocki	Entity
adagio	Concept
canon	Concept
country music	Concept
turntablists	Concept
drum kit	Concept
smooth jazz	Concept
cool jazz	Concept
piano	Concept
Grapevyne	Entity
goth	Concept
Steve Mackey	Entity
crash cymbals	Concept
AC/DC	Entity
Stereolab	Entity
Kenny Hickey	Entity
delta blues	Concept
trumpet	Concept
carioca	Concept
Never Say Die	Entity
backup	Concept
tango	Concept
homophony	Concept
My Chemical Romance	Entity
harp	Concept
Fidelio	Entity
discant	Concept
vocal jazz	Concept
short form	Concept
sheet music	Concept
ukelele	Concept
gramophone	Concept
Deep Purple	Entity
riff	Concept
harmonica blues	Concept
Edwin Birdsong	Entity
temple blocks	Concept
Sonic Youth	Entity
idyll	Concept
chantey	Concept
tubular bells	Concept
rider	Concept
industrial dance	Concept
religious song	Concept
harmonization	Concept
For Sleepyheads Only	Entity
impromptu	Concept
gradual	Concept
italian pop	Concept
rackett	Concept
Sex Pistols	Entity
mazurkas	Concept
Cypress Hill	Entity
reggaeton	Concept
dance music	Concept
air	Concept
septet	Concept
leitmotif	Concept
new age	Concept
preamble	Concept
Supernatural	Entity
Brazilian rock	Concept
metal	Concept
folk song	Concept
ambient	Concept
arena rock	Concept
cumbia	Concept
flageolet	Concept
polonaise	Concept
martial music	Concept
choir	Concept
harmonium	Concept
serious music	Concept
Some Kinda Rush	Entity
David Bisbal	Entity
progressive	Concept
Shadows Fall	Entity
symphony	Concept
My Bloody Valentine	Entity
maracas	Concept
drumming	Concept
grand opera	Concept
accompaniment	Concept
ballad	Concept
phrase	Concept
hornpipe	Concept
organ	Concept
riot grrl	Concept
bop	Concept
passage	Concept
Brian Wilson	Entity
cadenza	Concept
Wu-Tang Clan	Entity
mariachi	Concept
rock'n'roll	Concept
ranchera	Concept
twelve-tone music	Concept
preludes	Concept
glockenspiel	Concept
Mackey Feary	Entity
motive	Concept
traditional blues	Concept
tune	Concept
chanting	Concept
bolero	Concept
finger cymbals	Concept
lament	Concept
Liz Phair	Entity
torch song	Concept
Gentle Giant	Entity
Oasis	Entity
Sky Blue Sky	Entity
Blue Monday	Entity
triangle	Concept
instrumentation	Concept
Tom Waits	Entity
chicago blues	Concept
Grateful Dead	Entity
jam bands	Concept
solfege	Concept
duo	Concept
Fallen	Entity
dream pop	Concept
duranguense	Concept
bassoon	Concept
tom-tom	Concept
salutation	Concept
snare drum	Concept
percussion	Concept
gospel singing	Concept
bluegrass	Concept
Handbags and Gladrags	Entity
electronic pop	Concept
Avalon	Entity
grand piano	Concept
lo-fi	Concept
church music	Concept
alto clarinet	Concept
conductor	Concept
augmentation	Concept
musical theme	Concept
kwela	Concept
zydeco	Concept
progressive metal	Concept
singalong	Concept
modulation	Concept
The Reeling	Entity
claves	Concept
The Clash	Entity
bass	Concept
duet	Concept
Photograph	Entity
blues rock	Concept
pop music	Concept
contemporary blues	Concept
chant	Concept
Mute Print	Entity
medley	Concept
Velvet Monkeys	Entity
clavichord	Concept
clarinette basse	Concept
r and b	Concept
anticlimax	Concept
Joy Division	Entity
clarinet	Concept
Louis Armstrong	Entity
excerpt	Concept
antique cymbals	Concept
Pakistani rock	Concept
Quincy Jones	Entity
Rockfest	Entity
sitar	Concept
rap music	Concept
modern jazz	Concept
Boy George	Entity
minuet	Concept
folk ballad	Concept
movie soundtrack	Concept
Genesis	Entity
chorus	Concept
piece	Concept
music box	Concept
Basket Case	Entity
Spiderwebs	Entity
punk-pop	Concept
Bounce	Entity
Group Therapy	Entity
alternative rock	Concept
musical composition	Concept
cymbal	Concept
work song	Concept
european jazz	Concept
tambourine	Concept
obbligato	Concept
Kiss	Entity
fantasies	Concept
urban folk	Concept
polka	Concept
minuets	Concept
sarabande	Concept
disco music	Concept
Krush	Entity
instrumental	Concept
Robert Cray	Entity
a cappella singing	Concept
Silverthorn	Entity
country rock	Concept
Pink Floyd	Entity
glissando	Concept
flourish	Concept
amplifier	Concept
classic country	Concept
aria	Concept
marching music	Concept
cittern	Concept
The War	Entity
clapper	Concept
Jim O'Rourke	Entity
tuba	Concept
pop	Concept
ground	Concept
bagpipe	Concept
Someday Came Suddenly	Entity
Metallica	Entity
techno	Concept
sonatina	Concept
reharmonization	Concept
inversion	Concept
Stravinsky	Entity
opening	Concept
euphony	Concept
Lollipops and Roses	Entity
Madonna	Entity
Nas	Entity
finale	Concept
violoncello	Concept
world dance	Concept
folksong	Concept
baritone guitar	Concept
Duran Duran	Entity
scat singing	Concept
Ascendancy	Entity
basset horn	Concept
Salvation	Entity
psytrance	Concept
Led Zeppelin	Entity
rock music	Concept
Latin jazz	Concept
Nevermind	Entity
recessional	Concept
Backstreet Boys	Entity
Pete Yorn	Entity
antiphon	Concept
cowboy	Concept
opus	Concept
boogie	Concept
keyed trumpet	Concept
Gittler guitar	Concept
ground bass	Concept
strain	Concept
The Shins	Entity
John Peel	Entity
Planningtorock	Entity
baritone saxophone	Concept
toccata	Concept
melodic line	Concept
madrigal	Concept
Peter Gabriel	Entity
harmonisation	Concept
new jazz	Concept
Johnny Cash	Entity
yodeling	Concept
chansons	Concept
Summertime	Entity
solmization	Concept
Fursaxa	Entity
antiphonal	Concept
indie rock	Concept
Indorock	Entity
program music	Concept
orchestration	Concept
quartette	Concept
merengue	Concept
dance	Concept
Eminem	Entity
King Crimson	Entity
tone poems	Concept
adult alternative	Concept
pastorale	Concept
Benny Goodman	Entity
canticle	Concept
Christian rock	Concept
Ilosaarirock	Entity
trio sonata	Concept
bachata	Concept
ratchet	Concept
Tool	Entity
dixieland	Concept
composition	Concept
outlaw country	Concept
musette	Concept
new jack	Concept
Brian Eno	Entity
Mikey Chung	Entity
whistling	Concept
flamenco	Concept
dirge	Concept
kick drum	Concept
flugelhorn	Concept
bagatelle	Concept
xylophone	Concept
Artwork	Entity
swing jazz	Concept
Les Claypool	Entity
sheng	Concept
stride piano	Concept
djembe	Concept
dubstep	Concept
musical bow	Concept
chorale prelude	Concept
seven-string guitar	Concept
recapitulation	Concept
four-part harmony	Concept
western swing	Concept
monophony	Concept
Shamrock Diaries	Entity
grupero	Concept
latin rock	Concept
Art of Life	Entity
skiffle	Concept
adult contemporary	Concept
american alternative	Concept
monochord	Concept
rebec	Concept
Whiskey Tango Ghosts	Entity
zither	Concept
east coast	Concept
opera	Concept
tin pan alley	Concept
ligature	Concept
Dreamtime	Entity
Motörhead	Entity
pedal	Concept
quadrille	Concept
Your Favorite Weapon	Entity
americana	Concept
Dave Brockie	Entity
Ira D. Sankey	Entity
musical arrangement	Concept
horn	Concept
Dizzy Gillespie	Entity
AKB48	Entity
vibraphone	Concept
post hardcore	Concept
The Cure	Entity
elegies	Concept
