grafting	Concept
hillock	Concept
Seanad	Concept
Lake District	Entity
AI	Concept
Nadezhda von Meck	Entity
MetroLink	Entity
Burnaby	Entity
racoon	Concept
miscarriage of justice	Concept
Sylvette	Entity
crumpet	Concept
appearing	Concept
cap	Concept
Paul Bremer	Entity
spot price	Concept
dishwater	Concept
assistance	Concept
Brookline	Entity
Deputy	Concept
Oklahoma Corporation Commission	Entity
real estate	Concept
mentor	Concept
conspiracy	Concept
tartar	Concept
successor	Concept
Phi Sigma Sigma	Entity
intermittent claudication	Concept
workforce	Concept
fertility rate	Concept
dike	Concept
Katharine Hepburn	Entity
sapphire	Concept
POB	Concept
point	Concept
rheumatism	Concept
negation	Concept
catechumen	Concept
Shoot the Dog	Entity
blackface	Concept
Typhoon Lupit	Entity
casino	Concept
biosatellite	Concept
Drawing Restraint 9	Entity
boson	Concept
patient	Concept
Pauli	Entity
Ari Up	Entity
state of nature	Concept
John Pankow	Entity
stilt	Concept
diner	Concept
suite	Concept
notion	Concept
tableware	Concept
running	Concept
knight-errant	Concept
George Lamming	Entity
theme	Concept
trade embargo	Concept
Elizabeth Eisenstein	Entity
Nsanje	Entity
Emmeline Pankhurst	Entity
statice	Concept
9mm	Entity
workstation	Concept
metadata	Concept
Washington	Entity
Grosgrain	Concept
dirt	Concept
Savonarola	Entity
engineering	Concept
sigma	Concept
Bryher	Entity
signal	Concept
Mexico	Entity
contribution	Concept
militarization	Concept
environmental psychology	Concept
Andrew McCormick	Entity
New Jersey	Entity
differential	Concept
space	Concept
rat-catcher	Concept
director	Concept
colugo	Concept
Mel Gibson	Entity
source	Concept
intransitivity	Concept
Constantius	Entity
pragmatics	Concept
Zinc	Entity
Umayyad Mosque	Entity
palomino	Concept
inherited disease	Concept
subject	Concept
Porsche	Entity
Turrican	Entity
TimeShift	Entity
till	Concept
scallywag	Concept
autoresponder	Concept
road rage	Concept
sapote	Concept
power	Concept
circuit	Concept
LRRK2	Entity
department head	Concept
printing	Concept
Ronald Bunting	Entity
Cradle Will Rock	Entity
Red Planet	Entity
back porch	Concept
pane	Concept
explosion	Concept
Fayette County	Entity
Amsterdam Admirals	Entity
oat	Concept
Gitta Sereny	Entity
Phoebe Buffay	Entity
writer	Concept
Meat Puppets	Entity
strappado	Concept
buffer	Concept
Bradgate Park	Entity
Men at Work	Entity
Nohar	Entity
logotype	Concept
suzerainty	Concept
redundancy check	Concept
Landscape Arch	Entity
Auguste Rodin	Entity
deregulating	Concept
collegian	Concept
cheat	Concept
Taco Cabana	Entity
disobedience	Concept
glen	Concept
unification	Concept
chief research officer	Concept
promulgation	Concept
Muppet Babies	Entity
negritude	Concept
Newdale	Entity
Wellington Road	Entity
molecule	Concept
Tarheel	Concept
moderator	Concept
urus	Concept
Dublin Bus	Entity
attenuator	Concept
Hugh Capet	Entity
sawmill	Concept
Lutyens	Entity
bulkhead	Concept
toll road	Concept
Maxims	Entity
tragedy	Concept
clastic	Concept
assertion	Concept
flag	Concept
Jimmy Stewart	Entity
Eliezer Yudkowsky	Entity
cooking ingredient	Concept
credit card	Concept
lightning rod	Concept
Pinot blanc	Concept
Springboro	Entity
Jeremy Nathans	Entity
wand	Concept
crab	Concept
skin	Concept
Morris Carnovsky	Entity
life history	Concept
Younger Dryas	Entity
version	Concept
deserter	Concept
treasure map	Concept
blindfold	Concept
Sergei Shamba	Entity
nonverbal communication	Concept
couture	Concept
Vietnam	Entity
viral marketing	Concept
loaf	Concept
decal	Concept
designer	Concept
Achille	Entity
fading	Concept
fat	Concept
Russell Shorto	Entity
metropolitan area	Concept
charcoal	Concept
independent	Concept
hearsay rule	Concept
board	Concept
tax	Concept
defeat	Concept
die	Concept
junkware	Concept
throw	Concept
HDP	Entity
dragnet	Concept
Orlando Sentinel	Entity
Old Oaken Bucket	Entity
Hamilton Airport	Entity
Grani	Entity
smew	Concept
Gabriel Guerra	Entity
exposition	Concept
leger	Concept
UDP Lite	Entity
ruby	Concept
SpamBayes	Entity
dentist	Concept
brachydactyly	Concept
ordinary	Concept
developmental disability	Concept
monoid	Concept
victimization	Concept
AT&T	Entity
cesarean delivery	Concept
maltreatment	Concept
ultranationalism	Concept
heptose	Concept
covenant	Concept
Chef Menteur Pass	Entity
gold coin	Concept
Dave Littlefield	Entity
extropy	Concept
front	Concept
Monash Freeway	Entity
Emmett Tyrrell	Entity
About.com	Entity
festivity	Concept
academic year	Concept
strangulation	Concept
Serpens	Entity
Trimble	Entity
kidney transplantation	Concept
tectonics	Concept
Robert Adams	Entity
horseman	Concept
video	Concept
Turonian	Entity
shoulder	Concept
timber	Concept
Fahrenheit	Entity
samurai	Concept
enrollee	Concept
coiner	Concept
John Edward Taylor	Entity
human	Concept
grits	Concept
diameter	Concept
Phil Silvers	Entity
loom	Concept
financial aid	Concept
snow	Concept
Cnidaria	Concept
Wiktionary	Entity
sarcophagus	Concept
Madia	Concept
Helene Deutsch	Entity
Robert Frost	Entity
shortsightedness	Concept
Preston Manning	Entity
dub	Concept
century	Concept
law	Concept
John McPherson	Entity
subpoena	Concept
viscometry	Concept
maple leaf	Concept
imperialism	Concept
shock	Concept
Stokes drift	Concept
prescription	Concept
shell	Concept
photography	Concept
Catscratch	Entity
management	Concept
cusp	Concept
puffing	Concept
Ludwig Boltzmann	Entity
generation	Concept
quietness	Concept
flavour	Concept
Deutschland	Entity
selection	Concept
linkage	Concept
psychedelic	Concept
heartburn	Concept
Before Dark	Entity
powertrain	Concept
City of Whitehorse	Entity
gigahertz	Concept
Valley Girls	Entity
Arapaho	Entity
syllabication	Concept
bend	Concept
roomette	Concept
This Love	Entity
Denning	Entity
Sphagnum	Concept
emery cloth	Concept
district court	Concept
endeavour	Concept
phonetic transcription	Concept
terrier	Concept
eudaimonia	Concept
Cromford Canal	Entity
sun	Entity
patchwork	Concept
Maginot	Entity
riel	Concept
November	Entity
breakfast	Concept
pleurisy	Concept
torture	Concept
miscreant	Concept
tempestuousness	Concept
Johan Remkes	Entity
Orange	Entity
nuclear energy	Concept
Simon Walker	Entity
East Capitol Street	Entity
grave	Concept
gluon	Concept
fellah	Concept
hypostasis	Concept
grass	Concept
telemovie	Concept
AAC	Entity
lemongrass	Concept
shed	Concept
response	Concept
prince consort	Concept
aerodrome	Concept
jockey	Concept
blueness	Concept
Hermes	Entity
yawl	Concept
immurement	Concept
satoyama	Concept
open proxy server	Concept
Erna Brodber	Entity
country	Concept
alumnus	Concept
Gainesville	Entity
ulnar artery	Concept
Cooperation and Development	Entity
marquee	Concept
sea	Concept
Saadia Gaon	Entity
preparation	Concept
sociology department	Concept
Analytical Engine	Entity
blame	Concept
white coat	Concept
affection	Concept
Knoxville	Entity
ounce	Concept
budget	Concept
bothy	Concept
Jon Clardy	Entity
small	Concept
indisposition	Concept
carbon dioxide	Concept
ultramicroscope	Concept
florin	Concept
spile	Concept
screen	Concept
Secant	Concept
gypsum	Concept
burning	Concept
Karl Sax	Entity
Francisco Pizarro	Entity
sustainable tourism	Concept
Hadrian	Entity
frond	Concept
tropopause	Concept
Gene DeWeese	Entity
Zimbabwean	Concept
trailing	Concept
pocketbook	Concept
behaviourism	Concept
Jane Asher	Entity
netherworld	Concept
supernaturalism	Concept
Mossbank	Entity
agitation	Concept
integration	Concept
airport	Concept
dhow	Concept
attorney	Concept
glutton	Concept
Leipzig	Entity
freightage	Concept
hydrogeology	Concept
Don Baldwin	Entity
VersionTracker	Entity
shoal	Concept
kinetic theory	Concept
Margaret Robinson	Entity
Como	Entity
Platt	Entity
San Andreas	Entity
Bill Wise	Entity
limousine	Concept
lava	Concept
bowsprit	Concept
capture	Concept
Lautrec	Entity
Dorion Sagan	Entity
Flo Ziegfeld	Entity
serfdom	Concept
Sandy Mitchell	Entity
baronet	Concept
Micronesia	Entity
turnpike	Concept
mode	Concept
Tharsis	Entity
guerilla	Concept
Buchenwald	Entity
tooth	Concept
certified check	Concept
ley	Concept
form	Concept
radish	Concept
McCormick County	Entity
lustiness	Concept
slut	Concept
settlement	Concept
mischance	Concept
wetsuit	Concept
telescope	Concept
St. Edward	Entity
issuer	Concept
vaporization	Concept
photographer	Concept
Caddoan	Concept
hand drill	Concept
Mjolnir	Entity
patent	Concept
Jason Harris	Entity
Turtle Mountains	Entity
Mayon Volcano	Entity
cingulate gyrus	Concept
biotechnology	Concept
newsletter	Concept
spell-checker	Concept
leveling	Concept
madam	Concept
lyceum	Concept
universal suffrage	Concept
spearmint	Concept
Susan B. Anthony	Entity
Dara Horn	Entity
Boulder Creek	Entity
liquid	Concept
weapon	Concept
jerky	Concept
natural gas	Concept
Chicago	Entity
harvesting	Concept
frequence	Concept
flood	Concept
empire	Concept
turbofan	Concept
Cyprus	Entity
snooze	Concept
State Highway 17	Entity
archeologist	Concept
accreditation	Concept
petition	Concept
Reckless Kelly	Entity
coal	Concept
megabyte	Concept
balk	Concept
Zhao Ziyang	Entity
referral	Concept
teleportation	Concept
Chevrolet SSR	Entity
homophone	Concept
relative humidity	Concept
James Nash	Entity
militia	Concept
apartment	Concept
guard	Concept
navigator	Concept
stairway	Concept
brewing	Concept
color constancy	Concept
crosswind	Concept
lava dome	Concept
family therapy	Concept
Theodore Roethke	Entity
delay	Concept
Manassas	Entity
Agrippina	Entity
DirectX	Entity
consummation	Concept
escrow	Concept
mill	Concept
Mae West	Entity
mackerel	Concept
cypher	Concept
chips	Concept
Nyahururu	Entity
Precambrian	Entity
Myrdal	Entity
burgh	Concept
calmodulin	Concept
price of admission	Concept
chaff	Concept
pontiff	Concept
Michael Slote	Entity
modeling	Concept
bulk	Concept
exercise	Concept
Israel	Entity
gdbserver	Concept
impression	Concept
beacon	Concept
seafloor	Concept
HandBrake	Entity
caldera	Concept
relative price	Concept
vivisection	Concept
Reddit	Entity
tetramethylammonium hydroxide	Concept
vigabatrin	Concept
parents	Concept
transmission	Concept
convert	Concept
hill	Concept
Winsor School	Entity
Copper oxide	Concept
cent	Concept
history of science	Concept
whiteness	Concept
elopement	Concept
lofepramine	Concept
radio	Concept
executive vice president	Concept
extramarital sex	Concept
paragraph	Concept
cell death	Concept
zabaglione	Concept
antioxidant	Concept
bastinado	Concept
Goonellabah	Entity
single tax	Concept
Bradbury Science Museum	Entity
gamboge	Concept
saprolite	Concept
incandescence	Concept
pathfinder	Concept
tenement	Concept
wave	Concept
makeover	Concept
voltage divider	Concept
dual carriageway	Concept
Griselda	Entity
rainfall	Concept
Tom Hanks	Entity
agar	Concept
rockfish	Concept
Taiwan Relations Act	Entity
greenmail	Concept
Jean Coralli	Entity
minors	Concept
Transantarctic Mountains	Entity
Osbert Sitwell	Entity
Africa	Entity
chai tea	Concept
25th Hour	Entity
check-in	Concept
brittle	Concept
hero	Concept
report	Concept
turnstile	Concept
reporter	Concept
nuclear power plant	Concept
mail	Concept
acanthocephalan	Concept
granadilla	Concept
minke whale	Concept
closeness	Concept
Sachs Harbour	Entity
tectonic uplift	Concept
pipeline	Concept
mallet	Concept
quo warranto	Concept
machine	Concept
RF modulator	Concept
dinner	Concept
Ohio	Entity
Caligula	Entity
Mollie Katzen	Entity
savoy	Concept
Ben Gardner	Entity
annals	Concept
August	Concept
accounting	Concept
IBC	Entity
Dorset	Entity
Swarthmore	Entity
truffle	Concept
ineptitude	Concept
midfield	Concept
20th century	Concept
assist	Concept
farmer	Concept
ten thousand	Concept
chopper	Concept
full-duplex	Concept
wood	Concept
inclemency	Concept
Cinnamomum	Concept
Sam Rainsy	Entity
nag	Concept
song	Concept
viniculture	Concept
Muhammad Ali Jinnah	Entity
script	Concept
Carly Fiorina	Entity
writing	Concept
mould	Concept
Jon Cassar	Entity
valedictorian	Concept
parking	Concept
praise	Concept
Belarus	Entity
Albuquerque	Entity
golden rule	Concept
teamster	Concept
foolishness	Concept
restrictiveness	Concept
delegacy	Concept
society	Concept
page	Concept
Bislama	Entity
The Mail	Entity
Antony Leung	Entity
coffee	Concept
dealer	Concept
stripe	Concept
Bharata	Entity
transport	Concept
Surjit Singh Barnala	Entity
Indonesia	Entity
earthquake	Concept
Stanford	Entity
disposition	Concept
warrantor	Concept
supervolcano	Concept
note	Concept
environment	Concept
Bill Pullman	Entity
center	Concept
subspecies	Concept
climate	Concept
czar	Concept
freethought	Concept
potato salad	Concept
fire	Concept
palm	Concept
Adobe Flash Lite	Entity
birdwatching	Concept
squall line	Concept
heaven	Concept
fumigation	Concept
Richard Posner	Entity
copywriter	Concept
photolithography	Concept
Rell Sunn	Entity
syzygy	Concept
grenade	Concept
dashi	Concept
in-joke	Concept
cutoff	Concept
organ donor	Concept
freedman	Concept
skeet shooting	Concept
valuation	Concept
freight	Concept
owner-occupier	Concept
coalition	Concept
Bill Douglass	Entity
residence time	Concept
Anthony Hopkins	Entity
parameter	Concept
epistemology	Concept
accolade	Concept
Carlos Tosca	Entity
marine	Concept
cyclic guanosine monophosphate	Concept
Chris Phillips	Entity
distribution	Concept
anycast	Concept
journalism	Concept
housing	Concept
instrumental	Concept
font	Concept
capsule	Concept
raise	Concept
Windows	Entity
Vernon Jarrett	Entity
Allakhazam	Entity
electron microscopy	Concept
Blithe Spirit	Entity
senior	Concept
dress	Concept
chip	Concept
nu metal	Concept
dollar	Concept
pollock	Concept
evolutionary biologist	Concept
footman	Concept
tortilla	Concept
shopping	Concept
melanocyte	Concept
Olga Lengyel	Entity
steenbok	Concept
prexy	Concept
record label	Concept
infatuation	Concept
neck	Concept
wallop	Concept
cotton flannel	Concept
Dodie Bellamy	Entity
camlet	Concept
clopidogrel bisulfate	Concept
Showroom	Concept
Automatix	Entity
Helen of Troy	Entity
carbon	Concept
mother	Concept
suer	Concept
riptide	Concept
bug	Concept
haulier	Concept
Martha Blount	Entity
eversion	Concept
protist	Concept
Howard Davis	Entity
sonogram	Concept
collector	Concept
afterlife	Concept
hound	Concept
shamrock	Concept
stationmaster	Concept
bearing	Concept
standard	Concept
pill	Concept
army	Concept
still-life	Concept
margin	Concept
summit	Concept
city state	Concept
buckle	Concept
Hillbrow	Entity
Tutankhamun	Entity
harasser	Concept
hypertext markup language	Concept
Louisville	Entity
phase	Concept
cumulus	Concept
Rheal Cormier	Entity
drumbeat	Concept
prison	Concept
observance	Concept
FutureGen	Entity
Tacitus	Entity
horse	Concept
washing	Concept
summerhouse	Concept
high commissioner	Concept
temperament	Concept
matador	Concept
Itsu	Entity
university	Concept
Tarawa	Entity
French Broad River	Entity
sunspot	Concept
placebo effect	Concept
excitement	Concept
blind	Concept
health facility	Concept
Matthew Murphy	Entity
graphics	Concept
snatch	Concept
Austin	Entity
aldicarb	Concept
precipitation	Concept
matchlock	Concept
magnetic dipole	Concept
hometown	Concept
ironing	Concept
jade	Concept
Poeciliopsis	Concept
Bobby Williams	Entity
taka	Concept
Roos	Entity
World War II	Entity
selector	Concept
swamp gum	Concept
rep	Concept
basin	Concept
pollution	Concept
Copernic	Entity
white water	Concept
Michelle Thomas	Entity
pedestrian	Concept
Mike Breen	Entity
backwash	Concept
downlight	Concept
purplish-red	Concept
Marcel Duchamp	Entity
Kew Palace	Entity
straight	Concept
Hany Farid	Entity
gatekeeper	Concept
isolationism	Concept
ecclesiastic	Concept
greywacke	Concept
amaretto	Concept
Ridge Racer	Entity
village	Concept
Lander University	Entity
GraphicConverter	Entity
Scott City	Entity
Harold W. Dodds	Entity
Visual FoxPro	Entity
hacksaw	Concept
stepper	Concept
Aare	Entity
bloodguilt	Concept
Pindar	Entity
Nubian	Concept
biology	Concept
ruling	Concept
balsa raft	Concept
Standerton	Entity
fish	Concept
lysine	Concept
selective mutism	Concept
hustler	Concept
George Soros	Entity
John Franks	Entity
pellicle	Concept
New Orleans	Entity
rookery	Concept
telecommunications	Concept
turquoise	Concept
capital	Concept
polysemy	Concept
Feral Interactive	Entity
hard worker	Concept
scrutiny	Concept
BLAST	Entity
tower	Concept
Highlander	Entity
woofer	Concept
Europe	Entity
Susanna Clarke	Entity
debt	Concept
trade	Concept
Unreal Engine	Entity
MS	Entity
Epistles	Entity
shambles	Concept
flashlight	Concept
granularity	Concept
aqueduct	Concept
True Grit	Entity
sunshine	Concept
Paul Mellars	Entity
Act of Congress	Entity
stack	Concept
Qir	Entity
cricketer	Concept
shogunate	Concept
casserole	Concept
lunch	Concept
Phage	Entity
RELCOM	Entity
preserve	Concept
fess	Concept
Alec Stewart	Entity
lynching	Concept
Valetta	Entity
frogmouth	Concept
wingspread	Concept
poetry	Concept
sculpture	Concept
John Heydon	Entity
demonstration	Concept
Terrell High School	Entity
maliciousness	Concept
switcher	Concept
Simon Upton	Entity
oculist	Concept
playwriting	Concept
augmentation	Concept
indenture	Concept
language	Concept
sou	Concept
annual general meeting	Concept
Animorphs	Entity
Washburn High School	Entity
plastic	Concept
spell	Concept
Quebec	Entity
damages	Concept
disincentive	Concept
flak	Concept
shipping	Concept
tension	Concept
Yahoo	Entity
Bevis Hillier	Entity
Anthony Caro	Entity
Elbridge Gerry	Entity
Los Angeles	Entity
passing	Concept
malfeasance	Concept
Battlestar Galactica	Entity
trust company	Concept
Patrizia Ciofi	Entity
Day One	Entity
supervision	Concept
Ramesh Powar	Entity
rematch	Concept
day	Concept
medical emergency	Concept
Stardock	Entity
pet shop	Concept
Bennington	Entity
Local Group	Entity
D'Arcy Wentworth	Entity
Long Tack Sam	Entity
brute	Concept
catsuit	Concept
Mario Kart DS	Entity
children	Concept
smallpox virus	Concept
subtropics	Concept
judge	Concept
grapevine	Concept
broiler chicken	Concept
rail	Concept
designation	Concept
balsam	Concept
witness	Concept
soil pipe	Concept
Harmonia axyridis	Concept
noun	Concept
microprocessor	Concept
close combat	Concept
laser	Concept
staff	Concept
hornist	Concept
insemination	Concept
website	Concept
immateriality	Concept
slating	Concept
Bob Beers	Entity
narcolepsy	Concept
column	Concept
outlaw	Concept
Beowulf	Entity
police	Concept
Cementation	Concept
search engine	Concept
Mason & Dixon	Entity
piastre	Concept
steward	Concept
manslaughter	Concept
hardpan	Concept
coma	Concept
oil pollution	Concept
Merovingian	Entity
Gerrard Winstanley	Entity
tebuconazole	Concept
Paul Lafargue	Entity
Marjorie Garber	Entity
sport shirt	Concept
Fudan University	Entity
apple pie	Concept
phone call	Concept
Judd Gregg	Entity
interleaf	Concept
Malcolm Wallop	Entity
stymy	Concept
bondman	Concept
econometrics	Concept
policy	Concept
bioenergy	Concept
flavin	Concept
Comfortably Numb	Entity
larder	Concept
totient	Concept
Earthsea	Entity
Fruitlands	Entity
Gondi	Concept
Michigan	Entity
ethanol	Concept
ideal gas	Concept
Metal Gear Solid	Entity
herb tea	Concept
magazine	Concept
lithium	Concept
bere	Concept
hooded cloak	Concept
wrestler	Concept
Michael Costa	Entity
Gary Fong	Entity
Laurel Touby	Entity
Lancashire	Entity
triumvirate	Concept
El Mercurio	Entity
activator	Concept
bramble	Concept
attempt	Concept
rhizome	Concept
diorama	Concept
South Kensington	Entity
height	Concept
Tectonic	Entity
Beijing	Entity
macedonia	Concept
triskelion	Concept
adventure	Concept
rappel	Concept
Dejan Bodiroga	Entity
Virtual Console	Entity
nutrient	Concept
Meanjin	Entity
earl	Concept
Flagship Studios	Entity
highschool	Concept
regulating	Concept
quads	Concept
bell-bottoms	Concept
windage	Concept
confederation	Concept
complement	Concept
Jeff Francis	Entity
green olive	Concept
human rights	Concept
ground level	Concept
Delta Theta Phi	Entity
The Infinite Mind	Entity
Daniel Bernard Roumain	Entity
zephyr	Concept
stetson	Concept
Greccio	Entity
cancer	Concept
gateway	Concept
fasces	Concept
finalization	Concept
footway	Concept
colostrum	Concept
nutrition	Concept
photomicrograph	Concept
Halevi	Entity
department	Concept
Win Maung	Entity
tenpence	Concept
James Renwick	Entity
decomposition	Concept
conformist	Concept
aflatoxin	Concept
cribbage	Concept
Fredericksburg	Entity
philia	Concept
elimination	Concept
jackhammer	Concept
cornstarch	Concept
referee	Concept
blazonry	Concept
cobblestone	Concept
USS Housatonic	Entity
fault	Concept
journalist	Concept
Ape Escape	Entity
Riptide	Entity
Mixtec	Entity
flocculation	Concept
heedfulness	Concept
crusade	Concept
University of Liverpool	Entity
William Jordan	Entity
pigweed	Concept
potassium iodide	Concept
far left	Concept
pula	Concept
gelatin	Concept
chromatography	Concept
sparerib	Concept
stater	Concept
voyager	Concept
homeostasis	Concept
Under the Moon	Entity
ossification	Concept
Michael Owen	Entity
restitution	Concept
Serpens Caput	Entity
desiccation	Concept
religionism	Concept
quake	Concept
derogation	Concept
Tasman Glacier	Entity
antenna	Concept
feebleness	Concept
Lars Leksell	Entity
osteocyte	Concept
liberty	Concept
Cambridge	Entity
Slovenia	Entity
Bowhead whale	Concept
axile placentation	Concept
Sake	Entity
pulse	Concept
filial piety	Concept
Belt Line	Entity
tapis	Concept
court	Concept
needle	Concept
Seekonk	Entity
Huey Lewis	Entity
supermajority	Concept
sailing ship	Concept
Reconnaissance Battalion	Entity
Old Glory	Entity
label	Concept
W. Browning	Entity
rowlock	Concept
Miller	Entity
pe	Concept
Make the Grade	Entity
Ernie	Entity
retrieval	Concept
sustainability	Concept
phonics	Concept
sugar-cane	Concept
Oxford	Entity
mortar	Concept
GuideStar	Entity
RTLinux	Entity
light	Concept
OpenOffice	Entity
Thomas Phillipps	Entity
interior decoration	Concept
Bell	Entity
cox	Concept
Robert Key	Entity
Pressburg	Entity
Qarbon	Entity
Robert Barefoot	Entity
slicker	Concept
Monaco	Entity
Callender	Entity
patrician	Concept
coordinator	Concept
clerisy	Concept
Malvolio	Entity
chaldron	Concept
marriage	Concept
Jackson Zoo	Entity
spinal fusion	Concept
precision	Concept
Supersonics	Entity
Archaean	Entity
Brasilia	Entity
representative	Concept
oxalic acid	Concept
hyperlink	Concept
Green	Concept
Honeyd	Entity
brain	Concept
metre	Concept
Tennessee	Entity
Winston S. Churchill	Entity
earphones	Concept
Three Graces	Entity
City of London	Entity
sliminess	Concept
Iceland	Entity
Kingdom Hospital	Entity
paragonite	Concept
Richard Starkey	Entity
business software	Concept
Belfast Lough	Entity
club	Concept
Sigrid Nunez	Entity
Indians	Entity
authoress	Concept
condition	Concept
dance	Concept
O'Connor	Entity
singlet	Concept
carborundum	Concept
administrator	Concept
Siliana	Entity
Jemison	Entity
release	Concept
inspection	Concept
Intersection	Concept
Klaus Nomi	Entity
headmaster	Concept
Prentice Hall	Entity
Lucrezia Borgia	Entity
dicoumarol	Concept
mouse	Concept
Adam Crosthwaite	Entity
magnet school	Concept
railroad	Concept
special forces	Concept
Josef Gingold	Entity
aridity	Concept
Nikon F5	Entity
emergence	Concept
pool	Concept
specialist	Concept
Exodus	Entity
Isle of Arran	Entity
angular momentum	Concept
flip-flops	Concept
saltire	Concept
Aesculapius	Entity
sphygmomanometer	Concept
hostile fire	Concept
lira	Concept
facilitator	Concept
Tommy Gavin	Entity
Abutilon theophrasti	Concept
killer	Concept
regiment	Concept
Lawrence	Entity
bigtooth aspen	Concept
True Life	Entity
foreshadowing	Concept
monzonite	Concept
crisis	Concept
capability	Concept
tropical depression	Concept
decaf	Concept
pilot	Concept
cricket	Concept
deoxyribonucleic acid	Concept
felicity	Concept
Union Station	Entity
horsepower	Concept
synchronizer	Concept
Blisland	Entity
perry	Concept
water balloon	Concept
sial	Concept
John Flamsteed	Entity
metritis	Concept
diffusor	Concept
Korea	Entity
Louisiana	Entity
emperor	Concept
shepherd	Concept
commoner	Concept
sitagliptin	Concept
dormouse	Concept
quinine	Concept
school building	Concept
petty officer	Concept
Matthew Flinders	Entity
Hurricane Claudette	Entity
gabardine	Concept
ranch	Concept
Bernard Laporte	Entity
Sam Browne	Entity
Comet Hale-Bopp	Entity
UN	Entity
dicky	Concept
terawatt	Concept
photojournalism	Concept
emerald	Concept
Ubu Roi	Entity
benefaction	Concept
flooring	Concept
ox	Concept
GTA	Entity
inquisitor	Concept
Dale	Entity
cat	Concept
tropical storm	Concept
Augustine Volcano	Entity
Typhoon Xangsane	Entity
pin money	Concept
invalid	Concept
St. Augustine	Entity
cotton candy	Concept
handful	Concept
Internet	Concept
St. Bernard Software	Entity
colonial	Concept
share	Concept
incorporation	Concept
Aramaic	Entity
Tony Malaby	Entity
Talcott Parsons	Entity
Chuck Schumer	Entity
carat	Concept
subsoil	Concept
run batted in	Concept
employee	Concept
Joseph Stalin	Entity
calcium	Concept
kerchief	Concept
spokesman	Concept
Hamlet	Entity
hurdling	Concept
Poitiers	Entity
complicatedness	Concept
ringtone	Concept
junk	Concept
computer industry	Concept
Lido	Entity
hosiery	Concept
Herman Melville	Entity
envelopment	Concept
orison	Concept
Jack Lengyel	Entity
Stan Lee	Entity
studio	Concept
unsafe abortion	Concept
Xpdf	Entity
ammonium	Concept
anglophile	Concept
vigour	Concept
thiocyanate	Concept
sodium borohydride	Concept
Tim Dwight	Entity
Mohammad Yousuf	Entity
Tupelo Press	Entity
naturalist	Concept
King	Entity
payoff	Concept
clipping	Concept
BioCryst Pharmaceuticals	Entity
buckler	Concept
chronic	Concept
Hurricane Rita	Entity
Nahum Sonenberg	Entity
Brown	Entity
tax haven	Concept
star	Concept
Clean Edge	Entity
solfege	Concept
Julius Stone	Entity
Panthera pardus	Concept
Richard Kuklinski	Entity
camellia	Concept
outfit	Concept
palette	Concept
proton pump	Concept
laburnum	Concept
disc	Concept
eschaton	Concept
Alpha Omega Epsilon	Entity
Chris McKenna	Entity
Catherine Morland	Entity
Jane Elliott	Entity
inheritance	Concept
Yellowstone Caldera	Entity
Hurricane Dennis	Entity
Edmund Burke	Entity
pecan	Concept
Introducing	Entity
hedonism	Concept
Middlesex Guildhall	Entity
XML	Entity
softball	Concept
Semipalatinsk Test Site	Entity
MathWorks	Entity
maharaja	Concept
Maximum Carnage	Entity
staphylococci	Concept
TV	Concept
Modest Mouse	Entity
Giovanni Bellini	Entity
neurohypophysis	Concept
world	Concept
arms	Concept
Greek	Entity
geosphere	Concept
customs	Concept
Hurricane Wilma	Entity
Mike Allen	Entity
Novi Vinodolski	Entity
Beatrice	Entity
Crowds and Power	Entity
Jane Clifton	Entity
jacket	Concept
purslane	Concept
progressive	Concept
IRA	Concept
plumbing	Concept
gate	Concept
amazon	Concept
duke	Concept
Tropical Storm Cindy	Entity
Golden Gate Park	Entity
Turistas	Entity
aftermath	Concept
spotting	Concept
austral	Concept
advancement	Concept
money	Concept
White Star	Entity
recall	Concept
validity	Concept
tricolour	Concept
hovel	Concept
Health Sciences Library	Entity
Stephanian	Entity
currency	Concept
retribution	Concept
Anna Magnani	Entity
risotto	Concept
conglomerate	Concept
quarry	Concept
Joseph Rodman Drake	Entity
Kennedy	Entity
Capcom	Entity
twinjet	Concept
Amsterdam Internet Exchange	Entity
cell culture	Concept
pennon	Concept
proof	Concept
Richard Barnes Mason	Entity
faulting	Concept
Circle Jerks	Entity
placoderm	Concept
Valjean	Entity
planetary science	Concept
unintelligibility	Concept
Ernest Lehman	Entity
ideal	Concept
Republic of Turkey	Entity
scouter	Concept
cellulose	Concept
plasma	Concept
fils	Concept
Jurmo	Entity
Wisconsin	Entity
Scleranthus	Concept
intramuscular injection	Concept
steeper	Concept
Cyclone Gafilo	Entity
Dennis Lillee	Entity
Tau Kappa Epsilon	Entity
taxi	Concept
Tropical Storm Alpha	Entity
The Seven	Entity
Nathan Lane	Entity
John Livingston	Entity
dinky	Concept
spondee	Concept
documentary	Concept
floorshow	Concept
hospital	Concept
agriculture	Concept
Port Chester	Entity
asterism	Concept
Quantum mechanics	Concept
word	Concept
octillion	Concept
fishmeal	Concept
mestranol	Concept
Uraniborg	Entity
portraitist	Concept
breakwater	Concept
editor	Concept
outreach	Concept
boar	Concept
longbow	Concept
Jerry Aldridge	Entity
railyard	Concept
acre	Concept
jet stream	Concept
Dunbar	Entity
secular	Concept
headquarters	Concept
Moscow	Entity
judgment	Concept
track	Concept
studbook	Concept
permanent magnet	Concept
time	Concept
bye-election	Concept
