Dorothea Puente	Entity
lava dome	Concept
South Kensington	Entity
anticlimax	Concept
dicky	Concept
belfry	Concept
light	Concept
Pi Sigma Alpha	Entity
Myrdal	Entity
preserve	Concept
bolster	Concept
Korea	Entity
Roger Fry	Entity
rebel	Concept
thread	Concept
miscreant	Concept
grand	Concept
rabble-rouser	Concept
sailing ship	Concept
Urbana University	Entity
Talim	Entity
nitrification	Concept
festivity	Concept
Jim Beach	Entity
Ridge Racer	Entity
plantation	Concept
trust	Concept
nursery rhyme	Concept
Showroom	Concept
Matthew Flinders	Entity
closeness	Concept
Local Group	Entity
flak	Concept
autograph	Concept
Monaco	Entity
chopper	Concept
skeet shooting	Concept
palm	Concept
skepticism	Concept
smut	Concept
throw	Concept
chai tea	Concept
Cherryholmes	Entity
jeopardy	Concept
rheumatism	Concept
grounds	Concept
Minnamurra	Entity
financial aid	Concept
website	Concept
Dirac	Entity
