black music	Concept
Latin jazz	Concept
proto punk	Concept
Lollipop	Entity
opera	Concept
twelve-tone music	Concept
capriccio	Concept
invention	Concept
Robert Cray	Entity
Wrapped Around	Entity
Blue Monday	Entity
rock	Concept
bell lyre	Concept
Hockey	Entity
soul	Concept
concerto	Concept
trip-hop	Concept
Sonic Youth	Entity
minstrelsy	Concept
Brian Wilson	Entity
Mayhem	Entity
anthem	Concept
pastoral	Concept
latin pop	Concept
golden oldie	Concept
Renaissance music	Concept
rider	Concept
drum kit	Concept
Some Kinda Rush	Entity
cover song	Concept
bop	Concept
Dark Passion Play	Entity
Ira D. Sankey	Entity
tributes	Concept
jump blues	Concept
rock'n'roll	Concept
ocarina	Concept
singer-songwriter	Concept
Telegraph Road	Entity
Salvatore Adamo	Entity
impromptu	Concept
marching music	Concept
Miles Davis	Entity
divertimento	Concept
turntablists	Concept
country and western	Concept
cacophony	Concept
samba	Concept
bongo drum	Concept
Benny Goodman	Entity
coloratura	Concept
goth	Concept
composition	Concept
crash cymbals	Concept
ragtime	Concept
swing music	Concept
finale	Concept
Rolling Stones	Entity
extract	Concept
castanets	Concept
schottische	Concept
voice	Concept
bel canto	Concept
barcarolle	Concept
threnody	Concept
arrangement	Concept
Bob Dylan	Entity
obligato	Concept
solfege	Concept
dream pop	Concept
mbira	Concept
glam	Concept
djembe	Concept
Good Vibrations	Entity
Nirvana	Entity
Shakey Ground	Entity
Take Me Out	Entity
flamenco	Concept
orchestra bells	Concept
Paul McCartney	Entity
baritone horn	Concept
contemporary blues	Concept
punk-pop	Concept
Liz Phair	Entity
Rockfest	Entity
Tony Brock	Entity
bass	Concept
Heartland rock	Concept
skiffle	Concept
partita	Concept
modern jazz	Concept
quartet	Concept
David Foster	Entity
dithyramb	Concept
etude	Concept
accordion	Concept
glissando	Concept
shoegazing	Concept
dance	Concept
celesta	Concept
Someday Came Suddenly	Entity
negro spiritual	Concept
drumming	Concept
Stronger	Entity
singalong	Concept
tambourine	Concept
jamaican ska	Concept
classical music	Concept
wood block	Concept
Elton John	Entity
ground	Concept
tenor	Concept
quote	Concept
serious music	Concept
hillbilly music	Concept
transition	Concept
solo	Concept
duranguense	Concept
electronic pop	Concept
Ilosaarirock	Entity
drum & bass	Concept
Zeraphine	Entity
classic rock	Concept
shred	Concept
The Clovers	Entity
religious song	Concept
microphone	Concept
Whip My Hair	Entity
fantasia	Concept
double bass	Concept
clarinet	Concept
americana	Concept
folksong	Concept
marimba	Concept
oboe	Concept
My Chemical Romance	Entity
funk	Concept
hornpipe	Concept
Mike Hickey	Entity
Dance Revolution	Entity
four-part harmony	Concept
crumhorn	Concept
thumb piano	Concept
Angels Fall First	Entity
mouth organ	Concept
David Bowie	Entity
epigraph	Concept
dubstep	Concept
The Arrival	Entity
duet	Concept
bagpipe	Concept
epilogue	Concept
vocal blues	Concept
Latin hip-hop	Concept
Kaleidoscope	Entity
bugle	Concept
mezzo-soprano	Concept
ambient pop	Concept
vocal pop	Concept
panpipes	Concept
Fairport Convention	Entity
Strauss	Entity
Celtic rock	Concept
chicago blues	Concept
Eminem	Entity
Prince	Entity
neotraditional	Concept
gong	Concept
harmonica blues	Concept
X Japan	Entity
pedal	Concept
James Brown	Entity
lyre	Concept
French rock	Concept
keyed trumpet	Concept
east coast	Concept
hard rock	Concept
texas blues	Concept
Unity Band	Entity
Megadeth	Entity
fanfare	Concept
jam bands	Concept
conductor	Concept
ballet	Concept
oldies	Concept
All Wrapped Up	Entity
Marbles	Entity
Pennywise	Entity
folk music	Concept
The Shins	Entity
mazurkas	Concept
baritone saxophone	Concept
The Beyond	Entity
symphonic poem	Concept
chanting	Concept
chamber pop	Concept
christmas carol	Concept
bass saxophone	Concept
The Clash	Entity
masses	Concept
new jazz	Concept
Grappelli	Entity
dance music	Concept
Live Forever	Entity
Fidelio	Entity
stride piano	Concept
instrumental music	Concept
polyphonic music	Concept
short form	Concept
Damnation	Entity
Nevermind	Entity
tenor drum	Concept
preamble	Concept
Elvis Costello	Entity
death metal	Concept
harmonica	Concept
vocal	Concept
motive	Concept
shawm	Concept
Angela McCluskey	Entity
octet	Concept
musical arrangement	Concept
Seraphim	Entity
karaoke	Concept
rhumba	Concept
Summertime	Entity
Lithuanian rock	Concept
Bounce	Entity
transverse flute	Concept
carioca	Concept
melodic line	Concept
scat	Concept
clipping	Concept
power pop	Concept
adult contemporary	Concept
polka	Concept
Les Claypool	Entity
g√ºiro	Concept
diminution	Concept
Ascendancy	Entity
strain	Concept
symphony	Concept
lieder	Concept
Carl Davis	Entity
Yes	Entity
recapitulation	Concept
acoustic guitar	Concept
continuo	Concept
tone poem	Concept
section	Concept
rap music	Concept
modern blues	Concept
passage	Concept
teen pop	Concept
Origin	Entity
Irma	Entity
glam rock	Concept
ground bass	Concept
Manners	Entity
Duke Ellington	Entity
garage rock	Concept
krautrock	Concept
american punk	Concept
Never Say Die	Entity
Velvet Monkeys	Entity
The Crusade	Entity
support	Concept
euphony	Concept
basso continuo	Concept
Russian pop	Concept
Wu-Tang Clan	Entity
Deja Entendu	Entity
train whistle	Concept
ballroom music	Concept
nocturnes	Concept
ostinato	Concept
traditional	Concept
opening	Concept
passion	Concept
postlude	Concept
chimes	Concept
Indorock	Entity
mazurka	Concept
flute	Concept
popular music	Concept
potpourri	Concept
Aphex Twin	Entity
Kenny Hickey	Entity
electronica	Concept
gigue	Concept
recessional	Concept
preparation	Concept
fiddle	Concept
baroque pop	Concept
soft rock	Concept
riff	Concept
suspended cymbal	Concept
toccata	Concept
vibraphone	Concept
jaw harp	Concept
swedish pop	Concept
Krush	Entity
cadence	Concept
motif	Concept
sonatina	Concept
doo wop	Concept
variations	Concept
tuba	Concept
cantus firmus	Concept
korean pop	Concept
David Bisbal	Entity
Apoptygma Berzerk	Entity
lullaby	Concept
track	Concept
electric blues	Concept
ligature	Concept
Pavarotti	Entity
coda	Concept
cutting	Concept
surf guitar	Concept
lyricism	Concept
musette	Concept
Eurythmics	Entity
military music	Concept
chantey	Concept
descant	Concept
christian	Concept
fugues	Concept
tom-tom	Concept
chorale	Concept
Agoraphobia	Entity
vallenato	Concept
swing jazz	Concept
torch song	Concept
Phil Collins	Entity
progressive rock	Concept
canticle	Concept
bouffe	Concept
italian pop	Concept
folk	Concept
My My	Entity
septet	Concept
math rock	Concept
Mute Print	Entity
Neil Young	Entity
Fugazi	Entity
melodic theme	Concept
monochord	Concept
zither	Concept
refrain	Concept
discant	Concept
bass guitar	Concept
Pearl Jam	Entity
Shadows Fall	Entity
alto clarinet	Concept
autoharp	Concept
drum set	Concept
metal	Concept
house	Concept
preludes	Concept
Fleetwood Mac	Entity
The Whole Shebang	Entity
primo	Concept
sonata	Concept
counterpoint	Concept
new wave	Concept
roots rock	Concept
rock-and-roll	Concept
Frank Sinatra	Entity
chanty	Concept
r and b	Concept
musical theme	Concept
Like Drawing Blood	Entity
harmonisation	Concept
indie rock	Concept
Dizzy Gillespie	Entity
Sex Pistols	Entity
brazilian jazz	Concept
guitar	Concept
euro pop	Concept
pan flute	Concept
reharmonization	Concept
plainchant	Concept
post-punk	Concept
drums	Concept
piano	Concept
Mackey Feary	Entity
leitmotiv	Concept
cello	Concept
Kazimierz Serocki	Entity
light opera	Concept
realisation	Concept
timpani	Concept
Dream Theater	Entity
The Clearing	Entity
musical composition	Concept
piano music	Concept
Radiohead	Entity
prelude	Concept
salsa	Concept
freestyle	Concept
humming	Concept
motown	Concept
flugelhorn	Concept
lied	Concept
The Prodigy	Entity
fugue	Concept
southern rock	Concept
yodeling	Concept
Antichrist Superstar	Entity
gospel singing	Concept
keyboardist	Concept
new jack	Concept
Electric guitar	Concept
study	Concept
rainstick	Concept
country music	Concept
acoustic blues	Concept
operetta	Concept
aria	Concept
serialism	Concept
punk	Concept
Nas	Entity
Let It Be	Entity
Grapevyne	Entity
violoncello	Concept
clarinette basse	Concept
lullabies	Concept
mandolin	Concept
Annie Lennox	Entity
rag	Concept
hymnody	Concept
Avatar	Entity
bongos	Concept
Judas Priest	Entity
Stampede	Entity
The Doldrums	Entity
religious music	Concept
chamber music	Concept
pavane	Concept
Lose My Breath	Entity
regional blues	Concept
gradual	Concept
bongo drums	Concept
maracas	Concept
Beastie Boys	Entity
choir	Concept
euphonium	Concept
Lollipops and Roses	Entity
shanty	Concept
clapper	Concept
rock and roll	Concept
sarabande	Concept
vamp	Concept
chorale prelude	Concept
amplifier	Concept
progressive	Concept
variation	Concept
vocal jazz	Concept
sheng	Concept
drinking song	Concept
cool jazz	Concept
traditional blues	Concept
Bruce Springsteen	Entity
Hot Mess	Entity
movement	Concept
Artwork	Entity
gramophone	Concept
Donkey	Entity
Happily Ever After	Entity
american alternative	Concept
phrase	Concept
french pop	Concept
incidental music	Concept
crooning	Concept
vihuela	Concept
cittern	Concept
trumpet	Concept
Thornography	Entity
tenor tuba	Concept
adult alternative	Concept
country rock	Concept
shock rock	Concept
polyphony	Concept
polonaise	Concept
psalm	Concept
plainsong	Concept
Spiderwebs	Entity
martial music	Concept
lead sheet	Concept
Richie Havens	Entity
post hardcore	Concept
chorus	Concept
rap rock	Concept
new age	Concept
Pete Yorn	Entity
grand opera	Concept
John Peel	Entity
Christian rock	Concept
Dance-rock	Concept
