line segment	specifications	form	poker hand	straight line	track	shape	segment	installation art
plate armor	plate armour	scope	range	extent	board	sheet	armor	plate	shield
disrespect	discourtesy	disparagement	treatment
mapmaking	direction	cartography	spatial relation	cardinal direction
metallic element
function	lexical class	digit	code	figure	written language	part of speech	software program	decimal digit	computer program	text file	ascii text file	computer programme	integers	computer code	algorithm	software package	lexical category	coding system	formula	written communication	computer software
changeableness
entrance	entryway	passage	way	entry	entranceway
cell	skin cell	epidermal cell
city
plant	perennial	wilderness	woody plant	wild
distastefulness	unpleasantness	fullness
mode
ball	form	globe	sphere	shape	geometric shape	round shape	spheroid	orb
data storage device	storage
hockey player	sportsperson	riding horse	series	horseriding	television show	goaltender	statue	contestant	variable	likeness	olympic sport	sport	type of sport	communication medium	ice hockey player	population	visual arts	task	tv program	television series	transmission channel	writer	television program	person	tv show	competitor	three-dimensional figure	horseback riding	variable quantity	olympic sports	visual art	horsemanship	exposure	channel	movement
mention	stock	store	fund	stipulation	premise
gear mechanism	sending	mechanical assembly	mechanism
innings	turn
closing
carnivore	dogness	animal
wrongful act	murder	misconduct	slaying	first-degree murder	wrong	kill	capital crime	offense	killing	execution	evildoing	legal case	homicide	death	death penalty	mob	trial	summary execution	corporal punishment	criminal offense	penalization	wrongfulness	putting to death	cause of death	wrongdoing	wrongful conduct	conclusion	criminal offence	death sentence
money	payment	cost	spending
company
person	historian	journalist	writer	intellectual	literate
scriptwriter	person	writer	film writer	screenwriter
person	sculptor	carver	commune
network	computer network	computer networking	information network	communications system	telecommunication system	telecom system	information processing system	communication system	facility
spectral colour	red	violet	purple	colour	spectral color	purples	redness
fictitious character	person	imaginary creature	imaginary being	fictional character
firm	corporate identity	intellectual property	company	depiction	portraying	signaling	representational process	portrayal	depicting	concern	industrial property	corporation	prerogative	label	person	juridical person	language unit	branch
designated place	installation art
person
public park	park	space	green space
motorway	thruway	state highway	constructed structure	thoroughfare	route	superhighway	transport infrastructure	main road	freeway	throughway	infrastructure	way	controlled-access highway	expressway
imperial units	english units	imperial system	metric	unit of length	linear unit	system of measurement	british system	linear measure
h2o	fluid
bandmember	dance band	music group	rock group	rock band	band	musical group	team	musical organization
ketone
moth	animal
unnaturalness
city hall	town hall	hall	administrative building	public building	office building
shift	transformation	weakening
roadway	freeway	thruway	street	way	route	main road	motorway	fund	state highway	physical system	superhighway	controlled-access highway	expressway	store
evolution
shopping
attending
tunnel	passageway	way	constructed structure	passage
hostility	aggression	dispute	battle
transfer paper
