Tutankhamun	Entity
yawl	Concept
retainer	Concept
telemovie	Concept
Heming	Entity
biosatellite	Concept
molecule	Concept
bounty hunter	Concept
attic	Concept
Winston S. Churchill	Entity
defiance	Concept
snooze	Concept
slicker	Concept
balsa raft	Concept
stakes	Concept
apple pie	Concept
Hipparcos	Entity
shtup	Concept
Mayon Volcano	Entity
chai tea	Concept
Richard Posner	Entity
Robert Trivers	Entity
marketing research	Concept
Ronald Cass	Entity
acanthocephalan	Concept
passage	Concept
deserter	Concept
Blisland	Entity
Martelle	Entity
price reduction	Concept
Chromosome 9	Entity
cribbage	Concept
Hugh Capet	Entity
Lyon	Entity
Gunther Gebel-Williams	Entity
vigour	Concept
quote	Concept
Rockwell Kent	Entity
blastomere	Concept
chestnut	Concept
Grimm	Entity
health facility	Concept
pasqueflower	Concept
macroeconomics	Concept
Preston Manning	Entity
retail	Concept
MXML	Entity
potato	Concept
Scott	Entity
maharaja	Concept
