personal name	full name
person
search algorithm	routine	algorithm	protocol	rule	procedure	telescope	measuring instrument	instrument
town	city	provincial capital	capital
ship transport	vessel	vehicle	transport	mode of transport
prison cell	cell	tower	jail cell	holding cell
disturbance	illness	disorder	psychological disorder
ship transport	haircut	hairdo	hairstyle	haircutting	transportation	trend	hair style	passenger transport	hair styling	watercraft	vehicle	vessel	ship	military unit	mode of transport	transport
tv show
medical aid	health care	injection	treatment
convenience
software	application	application software	software package	software application	software program	computer program
motion	food energy	move	coding system	breath	weather	atmospheric condition	weather condition
money	monetary unit	definite quantity
public park	park	space	green space
24-hour interval	twenty-four hour period	day	time interval	period of time
person	sportswriter	journalist	writer
food product
taste	appreciation
disrespect	discourtesy	disparagement	treatment
horse	semblance	form	lover	horsie	solid figure	person	race	three-dimensional figure	admirer	wild horse	equus
country	sea nymph
theater	classical	person	opera
picture	work of art	moving picture	show	movie	pic	drama	picture show	motion picture	film	moving-picture show
party	group event	social occasion	social event
light	source of illumination	mechanism	light source
dirtiness	dirtying	environmental condition	impurity	sanitary condition	uncleanness
killer	ending	judgement	confinement	final decision	killing	judgment	penalty	final judgment	death	cause of death	conviction	due process	penalisation	penalization	putting to death	state	punishment
paramilitary	military force	paramilitary unit	military group	paramilitary organization	paramilitary force	military unit	paramilitary organisation	military organization
military branch	explorer	military machine	travel	adventurer	seaman	crewmember	crew member	person	military force	exploration	military man	military	combatant	military unit	enlisted person
school	observance	constructed structure	ceremonial	university	group event	educational institution	public building	hall
extinct volcano	mountain	harm	injury	toilet	mount	terrain	hurt	trauma	lithostratigraphic unit	volcano	separation process	locus
roadway	freeway	thruway	street	way	route	main road	motorway	fund	state highway	physical system	superhighway	controlled-access highway	expressway	store
person	historian	journalist	writer	intellectual	literate
slot	electrical network	component	add-in	controller	plug-in	integrated circuit	constituent	card	circuit board	microcircuit	electric circuit	switch	board	circuit	circuit card
subatomic particle	particle
sweet	confection	goody	retail outlet	treat
coin	debt instrument	mintage	tender	metal money	coinage	negotiable instrument
knight	person
tourist attraction
person	leader	politician	assistant
tourism
transmission	transmission channel	storage medium	technology	data-storage medium
antagonist	person
natural process
person	writer	russian literature
military leader	boss	person	chief	leader
plant product	drug	plant substance	vapor	physical phenomenon	natural phenomenon	natural process	phenomenon	air pollutant	marijuana	vapour	tobacco	cloud	environmental pollution
seafarer	sea dog	person
job market	market place
