reporter	Concept
Ada Comstock	Entity
horizontal bar	Concept
Leipzig	Entity
Allakhazam	Entity
incandescence	Concept
snag	Concept
Be Yourself	Entity
brutalisation	Concept
relay	Concept
Larderello	Entity
certified check	Concept
Anthony Hopkins	Entity
psychopathology	Concept
Leonidas	Entity
interior decoration	Concept
Grani	Entity
Seekonk	Entity
Jason Harris	Entity
babysitting	Concept
height	Concept
Phi Sigma Sigma	Entity
capital	Concept
blastomere	Concept
cotton candy	Concept
Reddit	Entity
price of admission	Concept
Pinot blanc	Concept
hornist	Concept
maharaja	Concept
Vorukh	Entity
Helene Deutsch	Entity
sod	Concept
antibody	Concept
Tufts University	Entity
charity	Concept
StarCraft	Entity
portraitist	Concept
clipping	Concept
Indra	Entity
hakim	Concept
syneresis	Concept
Umayyad Mosque	Entity
mischance	Concept
shipping	Concept
Louisville	Entity
William Jordan	Entity
Green	Concept
Nuptse	Entity
tragedy	Concept
