podcast	Concept
polysemy	Concept
curling	Concept
Sandy Mitchell	Entity
working capital	Concept
retrieval	Concept
Josh Willis	Entity
bigtooth aspen	Concept
Dionysia	Concept
sparerib	Concept
Joseph Rodman Drake	Entity
leaf curl	Concept
vulcanite	Concept
video	Concept
malware	Concept
discharge	Concept
spam	Concept
Susanna Clarke	Entity
Amoy	Concept
Giovanni da Verrazzano	Entity
house	Concept
Andrew Anderson	Entity
summit	Concept
streptomyces	Concept
palisade	Concept
accolade	Concept
Lutyens	Entity
resonance	Concept
hornist	Concept
mode	Concept
integration	Concept
Kristin Luker	Entity
Martha Blount	Entity
cricopharyngeus	Concept
diversity	Concept
pontiff	Concept
Dirac	Entity
praise	Concept
sou	Concept
Matt Dean	Entity
cast	Concept
hometown	Concept
Adobe Flash Lite	Entity
successor	Concept
Belfast Lough	Entity
Bryher	Entity
minke whale	Concept
Before Dark	Entity
child care	Concept
Sake	Entity
aileron	Concept
Bob Beers	Entity
attic	Concept
S4	Concept
moderator	Concept
Ari Up	Entity
reminiscence	Concept
birdwatching	Concept
Tasman Glacier	Entity
Roy Hattersley	Entity
Leonhard Euler	Entity
overpass	Concept
graduate	Concept
atomizer	Concept
redundancy check	Concept
Timothy Leary	Entity
dexterity	Concept
derogation	Concept
tomato soup	Concept
empennage	Concept
dealer	Concept
Kovel	Entity
space	Concept
Burnaby	Entity
beneficiary	Concept
disengagement	Concept
Intersection	Concept
Margaret Robinson	Entity
par	Concept
threat	Concept
Michelle Thomas	Entity
secular	Concept
parkway	Concept
Tutankhamun	Entity
Ronald Cass	Entity
diathermy	Concept
oil pollution	Concept
marquee	Concept
Flagship Studios	Entity
thread	Concept
aftermath	Concept
nag	Concept
northeaster	Concept
Olivia de Havilland	Entity
papillon	Concept
philia	Concept
commodity	Concept
white water	Concept
endeavour	Concept
Graduate House	Entity
volcanic rock	Concept
Dustin Hoffman	Entity
Ilex cassine	Concept
pigweed	Concept
sidestroke	Concept
rematch	Concept
Harold W. Dodds	Entity
stratum	Concept
El Mercurio	Entity
ruling	Concept
gegenschein	Concept
statice	Concept
record label	Concept
shirt	Concept
Greccio	Entity
variety	Concept
Lars Leksell	Entity
baguette	Concept
Bradgate Park	Entity
glade	Concept
ideal gas	Concept
shoulder	Concept
steward	Concept
handful	Concept
kink	Concept
star	Concept
sunspot	Concept
coffee	Concept
shellac	Concept
Russell Shorto	Entity
sandbox	Concept
docker	Concept
Chris Phillips	Entity
Haven	Entity
tropopause	Concept
greensand	Concept
outfielder	Concept
cloister	Concept
German mark	Concept
Cumberland Bay	Entity
Otto von Habsburg	Entity
executive vice president	Concept
chaff	Concept
AT&T	Entity
South East Wales	Entity
snooze	Concept
calumniation	Concept
Buchenwald	Entity
hallelujah	Concept
Hadrian	Entity
evolutionary biologist	Concept
lyceum	Concept
Maginot	Entity
shtup	Concept
nonsmoker	Concept
grenadilla	Concept
leopard cat	Concept
junkware	Concept
district court	Concept
John Munroe	Entity
Callender	Entity
Gitta Sereny	Entity
mycelium	Concept
expiration date	Concept
William Cowper	Entity
faulting	Concept
joystick	Concept
Universidad	Entity
pod	Concept
crooner	Concept
Bill Wise	Entity
gate	Concept
open-source software development	Concept
Kazak	Concept
WSRP	Entity
dicky	Concept
Korea	Entity
blazonry	Concept
Umayyad Mosque	Entity
Mossbank	Entity
thunder	Concept
summerhouse	Concept
Barney Bigard	Entity
Edmund Burke	Entity
Watergate	Entity
broiler chicken	Concept
Thanatos	Entity
waxwork	Concept
questionnaire	Concept
Albuquerque	Entity
human rights	Concept
switch	Concept
downlight	Concept
Tommy Gavin	Entity
plantation	Concept
abnegation	Concept
Deputy	Concept
whiteness	Concept
bottled water	Concept
avant-garde	Concept
northwester	Concept
telemovie	Concept
mug	Concept
Pindar	Entity
sociology department	Concept
suzerainty	Concept
endarteritis	Concept
Ian Bell	Entity
quarry	Concept
austral	Concept
burgh	Concept
plastic	Concept
camellia	Concept
round	Concept
ordinary	Concept
collector	Concept
9mm	Entity
Pinot blanc	Concept
platform	Concept
plate	Concept
sucralfate	Concept
Aaron Copland	Entity
Dairen	Entity
budget	Concept
shogunate	Concept
business concern	Concept
Port Huron	Entity
Siliana	Entity
aerofoil	Concept
baba	Concept
newsagent	Concept
pedagogue	Concept
Tellico Reservoir	Entity
guard	Concept
Venus	Entity
duke	Concept
journalism	Concept
Monash Freeway	Entity
postdoc	Concept
Burger King	Entity
John Talbot	Entity
Dorothy Richardson	Entity
Kaweah River	Entity
regulating	Concept
trust	Concept
teacher	Concept
conviction	Concept
engine	Concept
granadilla	Concept
Grimm	Entity
sheepshead	Concept
President Lyndon Johnson	Entity
calcium	Concept
Tennessee	Entity
powertrain	Concept
pipe	Concept
mould	Concept
mail	Concept
Ben Gardner	Entity
far left	Concept
schoolwork	Concept
Anna Magnani	Entity
Pusey	Entity
spelunker	Concept
megabyte	Concept
belt	Concept
Bomberman	Entity
Europe	Entity
rappel	Concept
delicacy	Concept
Hansel	Entity
feebleness	Concept
human migration	Concept
snag	Concept
verbal abuse	Concept
cumulus	Concept
Lawrence	Entity
European Parliament	Entity
clastic	Concept
Ivete Sangalo	Entity
kaon	Concept
Turrican	Entity
corporation	Concept
proposal	Concept
rubbing alcohol	Concept
bladder cancer	Concept
department head	Concept
Muppet Babies	Entity
Visalia	Entity
unsafe abortion	Concept
Archaean	Entity
bowsprit	Concept
Francisco Pizarro	Entity
monzonite	Concept
eversion	Concept
skeet shooting	Concept
Sam Rainsy	Entity
Timeless	Entity
Alex Sink	Entity
sunshine	Concept
Taiwan Relations Act	Entity
petition	Concept
acceptance	Concept
restaurant	Concept
grave	Concept
Hurricane Claudette	Entity
great-grandmother	Concept
WITI	Entity
bere	Concept
brutalisation	Concept
psychopathology	Concept
general	Concept
racoon	Concept
junk	Concept
Tibet	Entity
Amelia Earhart	Entity
Verlot	Entity
Typhoon Lupit	Entity
senior status	Concept
fumigation	Concept
wear	Concept
court	Concept
Boulder Creek	Entity
downtime	Concept
authoress	Concept
blunder	Concept
issuer	Concept
curiosa	Concept
watercraft	Concept
lie detector	Concept
Dublin Bus	Entity
veratrum	Concept
bloodguilt	Concept
gluon	Concept
oviduct	Concept
Under the Moon	Entity
version	Concept
observance	Concept
OpenOffice	Entity
lysine	Concept
magnetic dipole	Concept
Brown	Entity
hacksaw	Concept
dioxide	Concept
Raoul Dufy	Entity
viper	Concept
fresco	Concept
decentralisation	Concept
dragnet	Concept
Fyodor Dostoyevsky	Entity
cell culture	Concept
newsletter	Concept
actuator	Concept
Frederick Sanger	Entity
nuclear war	Concept
IRA	Concept
Anna Lindh	Entity
Arapaho	Entity
parameter	Concept
radical feminism	Concept
Johan Remkes	Entity
Jeremy Nathans	Entity
spell	Concept
scallywag	Concept
camera	Concept
ostracism	Concept
Walter Boyce	Entity
song thrush	Concept
New Orleans	Entity
racial profiling	Concept
differential	Concept
chai tea	Concept
label	Concept
availability	Concept
stomach	Concept
Point Lillias	Entity
comic	Concept
arm	Concept
Achille	Entity
Hudson	Entity
Adam Crosthwaite	Entity
agogo	Concept
language	Concept
tricolour	Concept
restitution	Concept
New Zealand	Entity
proteolysis	Concept
Nancy	Entity
Andronicus of Rhodes	Entity
heedfulness	Concept
FutureGen	Entity
viceroy	Concept
Como	Entity
PricewaterhouseCoopers	Entity
alluvium	Concept
Mario Kart DS	Entity
phone call	Concept
oil well	Concept
passing	Concept
Surjit Singh Barnala	Entity
stucco	Concept
Eteocles	Entity
Coinage Act	Entity
needlepoint	Concept
Murder One	Entity
ecology	Concept
snowfall	Concept
Llaima	Entity
Mollie Katzen	Entity
status epilepticus	Concept
shambles	Concept
doldrums	Concept
valedictorian	Concept
mortar	Concept
nuclear medicine	Concept
Qir	Entity
Union Station	Entity
change-of-pace	Concept
hearsay rule	Concept
monoid	Concept
admittance	Concept
nail	Concept
breechcloth	Concept
Deep learning	Concept
Battersea Arts Centre	Entity
Cementation	Concept
Bill Koski	Entity
small cap	Concept
carbon dioxide	Concept
Orlando Sentinel	Entity
Visual FoxPro	Entity
communization	Concept
Iran	Entity
TV	Concept
Tim Dwight	Entity
John McPherson	Entity
course	Concept
Reconnaissance Battalion	Entity
pipeline	Concept
chairman	Concept
IBM	Entity
shooter	Concept
sneeze	Concept
shamrock	Concept
Jack Trout	Entity
Aram I	Entity
torsion	Concept
outreach	Concept
Halo Wars	Entity
Roger Fry	Entity
Chicago	Entity
forum	Concept
eisteddfod	Concept
Hamlet	Entity
wine	Concept
Erna Brodber	Entity
Hero of Alexandria	Entity
crusade	Concept
Danish Kaneria	Entity
truffle	Concept
beacon	Concept
bread	Concept
Carly Fiorina	Entity
John Hodiak	Entity
pusher	Concept
bean	Concept
Manage	Entity
phonetic transcription	Concept
residence time	Concept
judge	Concept
Seema Biswas	Entity
balsam	Concept
Turtle Mountains	Entity
dicoumarol	Concept
tortilla	Concept
Deutschland	Entity
nursery rhyme	Concept
battle of Leuctra	Entity
Young	Entity
ghrelin	Concept
assignment	Concept
conformist	Concept
PubMed	Entity
dungeon	Concept
carbon	Concept
Neon Genesis Evangelion	Entity
tortilla chip	Concept
investment	Concept
coast	Concept
gradation	Concept
Miller	Entity
decomposition	Concept
ossification	Concept
Hurricane Epsilon	Entity
Fort Meade	Entity
Tropical Storm Alpha	Entity
patchwork	Concept
stairway	Concept
Lyon	Entity
USS Housatonic	Entity
Java	Entity
American Stock Exchange	Entity
tooth	Concept
proof	Concept
sub-interval	Concept
violet	Concept
Amsterdam Admirals	Entity
supermajority	Concept
Make the Grade	Entity
Larderello	Entity
century	Concept
behaviourism	Concept
seignior	Concept
Kathryn Werdegar	Entity
Myers-Briggs Type Indicator	Entity
Iran-Iraq War	Entity
pool	Concept
hauling	Concept
religionism	Concept
judgment	Concept
Monaco	Entity
wand	Concept
Bevis Hillier	Entity
blackfly	Concept
quake	Concept
stepper	Concept
Gerrard Winstanley	Entity
spelt	Concept
chronicler	Concept
Heming	Entity
MetroLink	Entity
annual report	Concept
nude	Concept
Copernic	Entity
ozone	Concept
Carlos Tosca	Entity
pomegranate	Concept
Standerton	Entity
environment	Concept
scouter	Concept
Hotel Europe	Entity
Chromosome 9	Entity
Dorion Sagan	Entity
terrier	Concept
scutcheon	Concept
Newdale	Entity
Orange	Entity
selector	Concept
compact disc	Concept
spring	Concept
electron microscopy	Concept
Bill Douglass	Entity
powerhouse	Concept
Africa	Entity
catechumen	Concept
ground	Concept
parents	Concept
hedonism	Concept
roaring	Concept
purplish-red	Concept
delegacy	Concept
bear	Concept
Mitchell Brown	Entity
UDP Lite	Entity
XML	Entity
theme	Concept
syllabication	Concept
Lachaise	Entity
Jimmy Stewart	Entity
Manarola	Entity
giantess	Concept
sun	Entity
incandescence	Concept
Isaiah	Entity
cricket	Concept
Richard Starkey	Entity
heartburn	Concept
logical thinking	Concept
turnpike	Concept
electorate	Concept
airlock	Concept
coda	Concept
university	Concept
in-joke	Concept
Tarawa	Entity
Mount St. Helens	Entity
disciple	Concept
Walter Gropius	Entity
road	Concept
immunologist	Concept
Hipparcos	Entity
bonemeal	Concept
ethanol	Concept
maliciousness	Concept
gerontocracy	Concept
Iceland	Entity
facilitator	Concept
expedition	Concept
inquisitor	Concept
minute	Concept
riel	Concept
mugwump	Concept
Suzy Favor Hamilton	Entity
flood	Concept
impression	Concept
relative humidity	Concept
bunionectomy	Concept
excommunication	Concept
Precambrian	Entity
Mae West	Entity
hit	Concept
Jason Harris	Entity
Beijing	Entity
top side	Concept
Wang Xin	Entity
Chevrolet SSR	Entity
fosterling	Concept
fasces	Concept
fiber	Concept
recycling	Concept
Adams Express Company	Entity
religion	Concept
oratory	Concept
driving	Concept
Ernie	Entity
Dalbergia melanoxylon	Concept
smuggler	Concept
Gram Parsons	Entity
tax haven	Concept
lustiness	Concept
tonne	Concept
chauvinism	Concept
fertility rate	Concept
rotter	Concept
Deck	Concept
sculpture	Concept
squall line	Concept
burr oak	Concept
baby tears	Concept
bayan	Concept
Figurines	Entity
nonverbal communication	Concept
A1 motorway	Entity
doeskin	Concept
civil union	Concept
Brady Smith	Entity
Jane Clifton	Entity
John Livingston	Entity
medical emergency	Concept
complaint	Concept
Pure Pinball	Entity
supervolcano	Concept
John Barclay	Entity
Nathan Lane	Entity
Savonarola	Entity
Post	Entity
yaupon holly	Concept
punishment	Concept
Michael Costa	Entity
Tulsa	Entity
smoothbore	Concept
farm animal	Concept
Nahum Sonenberg	Entity
washing	Concept
Wellington Road	Entity
complicatedness	Concept
coxswain	Concept
Indians	Entity
Woden	Entity
Willamette University	Entity
dentist	Concept
medalist	Concept
pane	Concept
sphygmomanometer	Concept
global warming	Concept
front	Concept
extramarital sex	Concept
tacking	Concept
Earthsea	Entity
carborundum	Concept
Cynthia McKinney	Entity
escheat	Concept
kidney transplantation	Concept
Bennington	Entity
rotunda	Concept
school year	Concept
village	Concept
shoal	Concept
Delta Theta Phi	Entity
drumbeat	Concept
czar	Concept
John Romer	Entity
Hugh Capet	Entity
brush-off	Concept
hypostasis	Concept
pungency	Concept
vibe	Concept
manslaughter	Concept
jerky	Concept
hospital	Concept
spare	Concept
retainer	Concept
Sonoma State University	Entity
playwriting	Concept
Fudan University	Entity
puzzler	Concept
Capcom	Entity
anglophile	Concept
Nohar	Entity
Loon	Entity
longbow	Concept
yardage	Concept
militia	Concept
trailing	Concept
gamesmanship	Concept
margin	Concept
Pope Pius X	Entity
Galeras	Entity
syzygy	Concept
George Lamming	Entity
Planck	Entity
advocacy	Concept
mill	Concept
skepticism	Concept
Semipalatinsk Test Site	Entity
Ryan Hall	Entity
Middle Ages	Entity
RTLinux	Entity
kingdom	Concept
wave	Concept
desiccation	Concept
Swami Haridas	Entity
petrology	Concept
Montlake Bridge	Entity
Crowds and Power	Entity
kinetic theory	Concept
Tony Trujillo	Entity
Frank Henry	Entity
GraphicConverter	Entity
freightage	Concept
Laksar	Entity
Talcott Parsons	Entity
hand drill	Concept
MXML	Entity
proton pump	Concept
Robert Frost	Entity
subspecies	Concept
Fort Sumter	Entity
octillion	Concept
release notes	Concept
loaf	Concept
cooking ingredient	Concept
quote	Concept
prexy	Concept
coiner	Concept
Mike Allen	Entity
General Intelligence Directorate	Entity
StarCraft	Entity
avenue	Concept
tipper	Concept
saprolite	Concept
quinine	Concept
growth	Concept
light	Concept
terminology	Concept
homeless	Concept
miscreant	Concept
children	Concept
decaf	Concept
Circle Jerks	Entity
Milton Shapp	Entity
Tau Kappa Epsilon	Entity
tornado	Concept
noble	Concept
The Infinite Mind	Entity
ulnar artery	Concept
annals	Concept
natural gas	Concept
Health Sciences Library	Entity
Yapese	Concept
indenture	Concept
rookery	Concept
scabies	Concept
jug	Concept
colugo	Concept
Z1	Entity
private eye	Concept
Green	Concept
Swarthmore	Entity
clopyralid	Concept
festivity	Concept
Saqqaq	Entity
bartlett	Concept
Pi Sigma Alpha	Entity
color	Concept
gasworks	Concept
babysitting	Concept
psychokinesis	Concept
algebra	Concept
Be Yourself	Entity
AI	Concept
radish	Concept
chess	Concept
archduke	Concept
stripe	Concept
switcher	Concept
masquerade ball	Concept
repair	Concept
stakes	Concept
weather forecasting	Concept
Riverboat Discovery	Entity
law	Concept
sapota	Concept
guest house	Concept
Agrippina	Entity
liquid	Concept
lordship	Concept
totient	Concept
Julia Child	Entity
distributer	Concept
interception	Concept
chip	Concept
Act of Congress	Entity
selection	Concept
hockey	Concept
mangonel	Concept
pollock	Concept
Eliezer Yudkowsky	Entity
Scarlet Diva	Entity
bomber	Concept
Susan Wiggs	Entity
Maximum Carnage	Entity
great-grandfather	Concept
validity	Concept
leishmaniasis	Concept
British Home Stores	Entity
vendue	Concept
pet shop	Concept
Cori	Entity
jade	Concept
Gurf Morlix	Entity
elimination	Concept
Judd Gregg	Entity
Renata Kallosh	Entity
Joseph Stalin	Entity
palm	Concept
Serpens	Entity
Michael Nielsen	Entity
RVF	Concept
Karl Friedrich Gauss	Entity
cistron	Concept
square sail	Concept
bush	Concept
Gainesville	Entity
malediction	Concept
viral marketing	Concept
pumpkin	Concept
palette	Concept
letter	Concept
Fredericksburg	Entity
Palazzo Farnese	Entity
Gary Fong	Entity
Susan B. Anthony	Entity
Panthera pardus	Concept
adventure	Concept
bed rest	Concept
metropolitan area	Concept
Ph.D.	Concept
Mike Breen	Entity
teddy	Concept
waistcoat	Concept
writing	Concept
couture	Concept
cypher	Concept
Ernest Lehman	Entity
licentiate	Concept
Himalaya	Entity
ladino	Concept
Springboro	Entity
Men at Work	Entity
multimeter	Concept
baronetcy	Concept
indisposition	Concept
fault	Concept
Dejan Bodiroga	Entity
Paul Philippe Cret	Entity
knight-errant	Concept
ineptitude	Concept
property owner	Concept
True Life	Entity
character	Concept
James Sallis	Entity
chest of drawers	Concept
HandBrake	Entity
cellulose	Concept
John Edward Taylor	Entity
failure rate	Concept
flak	Concept
Lake District	Entity
Cooperation and Development	Entity
autocracy	Concept
patrician	Concept
Bislama	Entity
deserter	Concept
male	Concept
Herman Melville	Entity
mestranol	Concept
Cradle Will Rock	Entity
Sergei Shamba	Entity
Plymouth	Entity
Ieuaf	Entity
oligoastrocytoma	Concept
Bell	Entity
Dorothea Puente	Entity
inverse distance weighting	Concept
dishwater	Concept
prefix	Concept
plume	Concept
Tony Malaby	Entity
timidness	Concept
world	Concept
Honeyd	Entity
Pauli	Entity
satoyama	Concept
tax	Concept
Bear Creek	Entity
Tarheel	Concept
railroad	Concept
killer	Concept
nomination	Concept
liberty	Concept
register	Concept
AAC	Entity
hyperboloid	Concept
prescription	Concept
Mark Tully	Entity
gypsum	Concept
government	Concept
Mjolnir	Entity
restrictiveness	Concept
police	Concept
fish	Concept
universal suffrage	Concept
Patrizia Ciofi	Entity
bioenergy	Concept
Azua	Entity
report	Concept
instrumental	Concept
collage	Concept
Newport Gwent Dragons	Entity
livery	Concept
witchgrass	Concept
copper	Concept
POB	Concept
Misti	Entity
Virtual Console	Entity
Harold Volkmer	Entity
Susan Strasberg	Entity
Lautrec	Entity
fat	Concept
anapsid	Concept
ridge	Concept
release	Concept
relevancy	Concept
Margaret Fuller	Entity
run batted in	Concept
diabetic nephropathy	Concept
hydrosphere	Concept
veranda	Concept
shell	Concept
cosmic dust	Concept
disk	Concept
Collin Peterson	Entity
IBC	Entity
Ceuta	Entity
Biebrza National Park	Entity
Ludwig Boltzmann	Entity
Secant	Concept
McCormick County	Entity
club	Concept
Greg Germann	Entity
laptop	Concept
impromptu	Concept
Franco Corelli	Entity
laser	Concept
collegian	Concept
autograph	Concept
real estate	Concept
convert	Concept
Joan Silber	Entity
rationing	Concept
Robert De Niro	Entity
State Highway 12	Entity
vehicle	Concept
Federal Records	Entity
Whitaker	Entity
Essex	Entity
insight	Concept
domain	Concept
posey	Concept
lava	Concept
flooding	Concept
documentary	Concept
dam	Concept
wind	Concept
hegemony	Concept
steeper	Concept
oriflamme	Concept
lift	Concept
Moscow	Entity
Joe Price	Entity
Jenny Oropeza	Entity
jockey	Concept
coal	Concept
surd	Concept
placebo effect	Concept
inch	Concept
territory	Concept
Intelligence Bureau	Entity
architecture	Concept
capital	Concept
Reuel Marc Gerecht	Entity
headquarters	Concept
state of nature	Concept
arms	Concept
Unix shell	Concept
winner	Concept
Antony Leung	Entity
chronic	Concept
staff	Concept
pafuramidine	Concept
official	Concept
empire	Concept
program	Concept
firm	Concept
hair	Concept
editor in chief	Concept
HMAS Perth	Entity
salamander	Concept
pinny	Concept
Clean Edge	Entity
Malcolm Wallop	Entity
penis bone	Concept
Jim Beach	Entity
Platt	Entity
Joyce	Entity
Sherlock Holmes	Entity
habit	Concept
route	Concept
tenement	Concept
City of Whitehorse	Entity
disposition	Concept
bend	Concept
compound	Concept
blank	Concept
horseshoer	Concept
Macklin	Entity
commuter rail	Concept
fifty	Concept
Battlestar Galactica	Entity
human	Concept
dwarf planet	Concept
Serpens Caput	Entity
afterlife	Concept
patient	Concept
Chef Menteur Pass	Entity
shawl	Concept
foreshadowing	Concept
liquidation	Concept
oxalic acid	Concept
turquoise	Concept
unintelligibility	Concept
photograph	Concept
island	Concept
homophone	Concept
timepiece	Concept
self-justification	Concept
Forest Way	Entity
noun	Concept
insignia	Concept
science journalism	Concept
striatum	Concept
Carlo Levi	Entity
writer	Concept
transit	Concept
Katharine Hepburn	Entity
seminar	Concept
sapote	Concept
narcolepsy	Concept
Kenai Peninsula	Entity
finalization	Concept
hyperlink	Concept
Automatix	Entity
Bronze Horseman	Entity
country	Concept
medical care	Concept
pension fund	Concept
Matthew Flinders	Entity
Durham	Entity
Mariamman	Entity
D-2	Entity
James Renwick	Entity
Bashi Channel	Entity
horsehair	Concept
Tupelo Press	Entity
sod	Concept
TimeShift	Entity
The Mail	Entity
door	Concept
Swing music	Concept
steppe	Concept
history of science	Concept
dhow	Concept
retribution	Concept
compiler	Concept
Creative	Entity
minister	Concept
Metal Gear Solid	Entity
timber	Concept
vigabatrin	Concept
line of duty	Concept
autoresponder	Concept
dunce cap	Concept
Tufts University	Entity
cutlery	Concept
lepton	Concept
Messi	Entity
blastomere	Concept
selective mutism	Concept
viniculture	Concept
green olive	Concept
foster-child	Concept
immurement	Concept
neck	Concept
small	Concept
sitagliptin	Concept
Kohler	Entity
cyclicity	Concept
emery cloth	Concept
Monster Magnet	Entity
intramuscular injection	Concept
photomicrograph	Concept
overhead	Concept
miscarriage of justice	Concept
retirement benefit	Concept
sawmill	Concept
Kingdom Hospital	Entity
climate	Concept
debenture	Concept
fine	Concept
baker	Concept
South Kensington	Entity
bramble	Concept
hustler	Concept
Caligula	Entity
Fourth World	Entity
midfield	Concept
literary critic	Concept
Vietnam	Entity
harvesting	Concept
Nuptse	Entity
cookhouse	Concept
rectory	Concept
Parveen Babi	Entity
supervision	Concept
Malvolio	Entity
mark	Concept
Straight River	Entity
frond	Concept
residence hall	Concept
Bradbury Science Museum	Entity
health economics	Concept
herb tea	Concept
wagoner	Concept
Ron Donagi	Entity
raise	Concept
consumption	Concept
local government	Concept
wicketkeeper	Concept
consummation	Concept
general contractor	Concept
Robert Trivers	Entity
Susannah York	Entity
Catoctin Mountain Park	Entity
Slovenia	Entity
emergence	Concept
tropical storm	Concept
airport	Concept
attempt	Concept
high commissioner	Concept
offense	Concept
Lido	Entity
affection	Concept
Michael Castleman	Entity
Stephanian	Entity
voyager	Concept
workingman	Concept
Middlesex Guildhall	Entity
instruction	Concept
slop	Concept
Hurricane Dennis	Entity
Herodian	Entity
sanctuary	Concept
Amis	Concept
Carlos Frenk	Entity
orison	Concept
counterclaim	Concept
yesterday	Concept
sustainability	Concept
Jump Cut	Entity
rail	Concept
greenmail	Concept
page	Concept
operation	Concept
aqueduct	Concept
Philip Durell	Entity
Mister Johnson	Entity
notebook computer	Concept
negation	Concept
Maryland	Entity
pathfinder	Concept
Reckless Kelly	Entity
pollution	Concept
spearmint	Concept
sharecropper	Concept
observation	Concept
spats	Concept
subsidy	Concept
snow	Concept
Arthur Ashe	Entity
Oxford	Entity
prototype	Concept
Uraniborg	Entity
I-20	Entity
horse	Concept
lousiness	Concept
foreign policy	Concept
beam	Concept
The Internet	Entity
Belarus	Entity
printing	Concept
quickening	Concept
village hall	Concept
telescope	Concept
quoit	Concept
studbook	Concept
Typhoon Muifa	Entity
staphylococci	Concept
permanent magnet	Concept
capsule	Concept
dragonfly	Concept
John Passmore	Entity
defiance	Concept
relative price	Concept
blockade	Concept
hardpan	Concept
portraitist	Concept
hurdling	Concept
inherited disease	Concept
Knoxville	Entity
reactionary	Concept
hooded cloak	Concept
acre	Concept
Kirk Fordice	Entity
urinary bladder	Concept
Trimble	Entity
sustainable tourism	Concept
MathWorks	Entity
tragedy	Concept
fund	Concept
blackface	Concept
flowage	Concept
white coat	Concept
Sino-Japanese War	Entity
rowlock	Concept
mentor	Concept
smew	Concept
Skara Brae	Entity
till	Concept
pseudogout	Concept
spaceport	Concept
grass	Concept
Wii	Entity
Simon Upton	Entity
spell-checker	Concept
triple	Concept
devotion	Concept
playlist	Concept
Czestochowa	Entity
camlet	Concept
Wernher von Braun	Entity
Sachs Harbour	Entity
service	Concept
Dance Mix	Entity
Robert Boyle	Entity
wood nymph	Concept
reaction	Concept
Fahrenheit	Entity
radio	Concept
res judicata	Concept
chopper	Concept
grit	Concept
pervert	Concept
Cocina	Entity
copywriter	Concept
inheritance	Concept
eudaimonia	Concept
lightning rod	Concept
angular momentum	Concept
corpus delicti	Concept
committee	Concept
Tectonic	Entity
Dionysius	Entity
certificate	Concept
allies	Concept
subject	Concept
wildlife	Concept
Wild Kingdom	Entity
Julius Stone	Entity
triskelion	Concept
diadem	Concept
Gerry Davis	Entity
horizontal bar	Concept
knickers	Concept
betaine	Concept
Ronas Hill	Entity
patent	Concept
Mota	Entity
journalist	Concept
owner	Concept
economic growth	Concept
Younger Dryas	Entity
Robert Barefoot	Entity
Itsu	Entity
beef	Concept
hero	Concept
freedman	Concept
Laurel Touby	Entity
robber	Concept
camelpox	Concept
Sajid Mahmood	Entity
streptomycin	Concept
VirtualDubMod	Entity
corneum	Concept
still-life	Concept
Xpdf	Entity
bank	Concept
delta	Concept
witch-hunt	Concept
DC	Concept
buckler	Concept
Meanjin	Entity
plumbing fixtures	Concept
business	Concept
Transantarctic Mountains	Entity
device	Concept
response	Concept
Scott	Entity
sodium borohydride	Concept
lira	Concept
lost cause	Concept
hacker	Concept
RF modulator	Concept
happening	Concept
stilt	Concept
employee	Concept
Fagopyrum	Concept
flare	Concept
Texas	Entity
Winsor School	Entity
IBM 1620	Entity
drinking	Concept
swamp gum	Concept
tower	Concept
St. Vitus	Entity
Scott Styris	Entity
interior decoration	Concept
paragonite	Concept
terawatt	Concept
gigahertz	Concept
macroeconomics	Concept
styrofoam	Concept
mackerel	Concept
Paul Lafargue	Entity
La Veta Pass	Entity
Caddoan	Concept
outlander	Concept
matador	Concept
left	Concept
whoredom	Concept
flashlight	Concept
workforce	Concept
hunting	Concept
Leon Battista Alberti	Entity
zephyr	Concept
fire service	Concept
White House	Entity
navigator	Concept
twopence	Concept
grand	Concept
grant	Concept
dress	Concept
animosity	Concept
assist	Concept
Hurricane Charley	Entity
Dorset	Entity
crosswind	Concept
spinal fusion	Concept
filial piety	Concept
turnstile	Concept
covenant	Concept
railyard	Concept
GuideStar	Entity
exposition	Concept
interleaf	Concept
smoke	Concept
bird sanctuary	Concept
Cecilia	Entity
ounce	Concept
alb	Concept
New Jersey	Entity
David Gustafson	Entity
dike	Concept
handshake	Concept
escudo	Concept
spile	Concept
waiver	Concept
bastinado	Concept
intermittent claudication	Concept
pocketbook	Concept
dividend	Concept
surprise	Concept
potato	Concept
sphinx	Concept
madam	Concept
Saadia Gaon	Entity
detour	Concept
cap	Concept
family therapy	Concept
Robert Pozen	Entity
Tropical Storm Cindy	Entity
rhizome	Concept
solid	Concept
saltire	Concept
Aramaic	Entity
respiratory disease	Concept
Jurmo	Entity
magistrate	Concept
charlotte	Concept
synthesis	Concept
transport	Concept
debt	Concept
eponychium	Concept
Old Glory	Entity
Pacaya	Entity
brownie	Concept
diploma	Concept
chromatography	Concept
pin money	Concept
sport	Concept
Louisiana	Entity
possession	Concept
dhole	Concept
vegetarian	Concept
source	Concept
épée	Concept
grounds	Concept
Cherryholmes	Entity
accreditation	Concept
hybrid	Concept
snowplow	Concept
Ridge Racer	Entity
cobblestone	Concept
software suite	Concept
topping	Concept
luffa	Concept
Theodore Roethke	Entity
boatlift	Concept
horseman	Concept
school building	Concept
truth	Concept
Catscratch	Entity
diameter	Concept
Phage	Entity
serfdom	Concept
John Flamsteed	Entity
20th century	Concept
plasma	Concept
avulsion	Concept
regiment	Concept
seamster	Concept
hard worker	Concept
wetsuit	Concept
tendentiousness	Concept
Craig Anderson	Entity
French Broad River	Entity
fire	Concept
activator	Concept
John Heydon	Entity
fellah	Concept
