Yankee Hotel Foxtrot	Entity
doo-wop	Concept
harmonica blues	Concept
conductor	Concept
Neil Young	Entity
Benny Goodman	Entity
disney	Concept
Taiwanese pop	Concept
backup	Concept
Led Zeppelin	Entity
mallet	Concept
swing music	Concept
idm	Concept
urban folk	Concept
rider	Concept
slide	Concept
augmentation	Concept
Just Dance	Entity
adult contemporary	Concept
Wu-Tang Clan	Entity
keyboardist	Concept
recessional	Concept
Loaded	Entity
vallenato	Concept
punk	Concept
alto clarinet	Concept
rainstick	Concept
Irma	Entity
Your Favorite Weapon	Entity
character piece	Concept
octet	Concept
blues rock	Concept
bluegrass	Concept
My My	Entity
british invasion	Concept
blues	Concept
bass part	Concept
traditional	Concept
celtic folk	Concept
rockabilly	Concept
postlude	Concept
opus	Concept
invention	Concept
hymn	Concept
pavan	Concept
antique cymbals	Concept
dixieland	Concept
gregorian chant	Concept
temple blocks	Concept
Pete Yorn	Entity
Up All Night	Entity
crash cymbals	Concept
playback	Concept
transition	Concept
military music	Concept
Peace of Mind	Entity
quickstep	Concept
industrial	Concept
garage rock	Concept
trio sonata	Concept
musical drama	Concept
Planet Earth	Entity
brazilian jazz	Concept
guitar	Concept
orchestration	Concept
Stevie Wonder	Entity
melodic phrase	Concept
garage punk	Concept
vocal harmony	Concept
Brian Eno	Entity
Joe Satriani	Entity
popular music	Concept
oratorio	Concept
golden oldie	Concept
doo wop	Concept
motet	Concept
christmas carol	Concept
bassoon	Concept
Blue Monday	Entity
John Peel	Entity
adagio	Concept
intro	Concept
canon	Concept
Telegraph Road	Entity
Oasis	Entity
score	Concept
triangle	Concept
Elvis Presley	Entity
mandolin	Concept
orchestral jazz	Concept
Group Therapy	Entity
Les Claypool	Entity
rag	Concept
chanson	Concept
concert grand piano	Concept
symphonic poem	Concept
monophony	Concept
Latin jazz	Concept
mariachi	Concept
tubular bells	Concept
Welcome the Night	Entity
bagpipe	Concept
ground	Concept
tarantella	Concept
obbligato	Concept
Spiderwebs	Entity
quotation	Concept
latin music	Concept
incidental music	Concept
christmas	Concept
French rock	Concept
Robert Cray	Entity
operetta	Concept
scherzo	Concept
west coast blues	Concept
obligato	Concept
Massive Attack	Entity
west coast	Concept
house	Concept
sarabande	Concept
pop metal	Concept
descant	Concept
new jack	Concept
preface	Concept
rock opera	Concept
operettas	Concept
twelve-tone system	Concept
The Ventures	Entity
recorder	Concept
Hockey	Entity
classical music	Concept
flugelhorn	Concept
The Doldrums	Entity
orchestra bells	Concept
classic rock	Concept
passage	Concept
ambient pop	Concept
singalong	Concept
For Sleepyheads Only	Entity
Nightshift	Entity
roots rock	Concept
Metallica	Entity
Mute Print	Entity
alternative rock	Concept
skiffle	Concept
Rockfest	Entity
Shakey Ground	Entity
contrabass clarinet	Concept
light opera	Concept
ukelele	Concept
stride piano	Concept
continuo	Concept
boogie-woogie	Concept
northern	Concept
The Prodigy	Entity
Iris	Entity
country music	Concept
bolero	Concept
cantata	Concept
outlaw country	Concept
Carl Davis	Entity
Yoshiki	Entity
rhythm and blues	Concept
variations	Concept
tenor drum	Concept
religious song	Concept
Some Kinda Rush	Entity
voice	Concept
bagatelle	Concept
Deja Entendu	Entity
harmonization	Concept
Hawkwind	Entity
polyphonic music	Concept
fiddle	Concept
Elvis Costello	Entity
fugues	Concept
pan flute	Concept
crumhorn	Concept
tin whistle	Concept
Apoptygma Berzerk	Entity
Alison Goldfrapp	Entity
fado	Concept
3 Words	Entity
flamenco	Concept
Manners	Entity
american punk	Concept
Silverthorn	Entity
Radiohead	Entity
musical composition	Concept
vocal music	Concept
dithyramb	Concept
church music	Concept
negro spiritual	Concept
songbook	Concept
Fidelio	Entity
preludes	Concept
Madonna	Entity
prelude	Concept
Frank Sinatra	Entity
orchestra	Concept
serial music	Concept
kalimba	Concept
singer-songwriter	Concept
concertos	Concept
After the Storm	Entity
gittern	Concept
Handbags and Gladrags	Entity
David Bowie	Entity
motive	Concept
alphorn	Concept
syncopation	Concept
drumming	Concept
art rock	Concept
The Rolling Stones	Entity
solo	Concept
autoharp	Concept
straight edge	Concept
bass clarinet	Concept
piano music	Concept
jamaican ska	Concept
anthem	Concept
punk-pop	Concept
country and western	Concept
clarinette basse	Concept
goth	Concept
Renaissance music	Concept
chant	Concept
cittern	Concept
My Chemical Romance	Entity
Cypress Hill	Entity
DJ Sharkey	Entity
chorale	Concept
jazz	Concept
Naked	Entity
Stampede	Entity
twelve-tone music	Concept
western swing	Concept
Public Enemy	Entity
death metal	Concept
Supraphon	Entity
jam bands	Concept
Celtic rock	Concept
threnody	Concept
paean	Concept
Sex Pistols	Entity
pastoral	Concept
ethnic music	Concept
psalmody	Concept
irish folk	Concept
ballet	Concept
rock-and-roll	Concept
dirge	Concept
Dizzy Gillespie	Entity
chanting	Concept
antiphonal	Concept
Kenny Hickey	Entity
electric guitar	Concept
Joy Division	Entity
recapitulation	Concept
Megadeth	Entity
introit	Concept
sleigh bells	Concept
american alternative	Concept
Grappelli	Entity
sing-a-longs	Concept
indie rock	Concept
gigue	Concept
medley	Concept
violin	Concept
r and b	Concept
ragtime	Concept
vocal blues	Concept
shock rock	Concept
percussion	Concept
gramophone	Concept
hip-hop	Concept
Nas	Entity
pastiche	Concept
Russian pop	Concept
chorale prelude	Concept
Indorock	Entity
scat singing	Concept
duo	Concept
crwth	Concept
amplifier	Concept
swedish pop	Concept
gospel singing	Concept
progressive metal	Concept
gradual	Concept
music box	Concept
gospel	Concept
musical theme	Concept
tune	Concept
clavichord	Concept
Avalon	Entity
bongos	Concept
microphone	Concept
misquote	Concept
ballroom music	Concept
Kazimierz Serocki	Entity
chimes	Concept
Heartland rock	Concept
traditional folk	Concept
classic country	Concept
Third Stage	Entity
polka	Concept
masses	Concept
folksong	Concept
harmony	Concept
trumpet	Concept
piccolo	Concept
Ilosaarirock	Entity
bachata	Concept
Take Me Out	Entity
intonation	Concept
piece	Concept
The Ultimate	Entity
bugler	Concept
theme	Concept
solfeggio	Concept
hard rock	Concept
Charlotte Church	Entity
disco music	Concept
accordion	Concept
alternative metal	Concept
rap music	Concept
Grateful Dead	Entity
Johnny Cash	Entity
twee pop	Concept
pastorale	Concept
plainchant	Concept
ostinato	Concept
gavotte	Concept
Ira D. Sankey	Entity
clipping	Concept
neotraditional	Concept
fugue	Concept
Only U	Entity
rondo	Concept
acoustic guitar	Concept
potpourri	Concept
mbira	Concept
Damnation	Entity
Chamberlin	Entity
metal	Concept
Photograph	Entity
dulcimer	Concept
polyphony	Concept
Paul McCartney	Entity
sitar	Concept
country	Concept
concerto	Concept
track	Concept
ranchera	Concept
nocturnes	Concept
chamber pop	Concept
Happily Ever After	Entity
Wrapped Around	Entity
Iron Maiden	Entity
symphony	Concept
march	Concept
timbales	Concept
Electric guitar	Concept
baton	Concept
quartette	Concept
trance	Concept
vamp	Concept
rebec	Concept
movement	Concept
industrial dance	Concept
glissando	Concept
excerpt	Concept
duranguense	Concept
acid rock	Concept
elegies	Concept
rackett	Concept
ballad	Concept
thumb piano	Concept
ska	Concept
intermezzo	Concept
antiphony	Concept
harmonium	Concept
cornet	Concept
sonatina	Concept
Origin	Entity
monody	Concept
AC/DC	Entity
maracas	Concept
Shamrock Diaries	Entity
rock	Concept
recitative	Concept
Bedrock Records	Entity
bebop	Concept
kick drum	Concept
homophony	Concept
modulation	Concept
canticle	Concept
carioca	Concept
movie soundtrack	Concept
a cappella singing	Concept
Trap House	Entity
Back on Track	Entity
torch song	Concept
folk music	Concept
bass	Concept
Grapevyne	Entity
canto	Concept
opening	Concept
comic opera	Concept
hot jazz	Concept
funk	Concept
largo	Concept
cadenza	Concept
musette	Concept
heavy metal	Concept
Liz Phair	Entity
latin pop	Concept
carol	Concept
math rock	Concept
musical	Concept
bongo drum	Concept
Russian guitar	Concept
castanets	Concept
grate	Concept
rocksteady	Concept
Gentle Giant	Entity
musical harmony	Concept
New Order	Entity
glam	Concept
serenade	Concept
Frank Zappa	Entity
idyll	Concept
Duran Duran	Entity
emo	Concept
singsong	Concept
turntablists	Concept
dance music	Concept
whistling	Concept
slapstick	Concept
rock and roll	Concept
primo	Concept
progressive rock	Concept
hornpipe	Concept
Salad Days	Entity
Hollywood	Entity
mouth organ	Concept
variation	Concept
piano sonata	Concept
discant	Concept
arena rock	Concept
jump blues	Concept
soundtrack album	Concept
timpani	Concept
Fallen	Entity
Backstreet Boys	Entity
Depeche Mode	Entity
post-punk	Concept
alto saxophone	Concept
modern blues	Concept
Phil Collins	Entity
divertimento	Concept
tenor	Concept
cymbal	Concept
leitmotiv	Concept
regional blues	Concept
cutting	Concept
signature	Concept
duet	Concept
U2	Entity
James Brown	Entity
short form	Concept
Bob Dylan	Entity
texas blues	Concept
clapper	Concept
old-time country	Concept
italian pop	Concept
voice part	Concept
Angela McCluskey	Entity
Kiss	Entity
Ramones	Entity
swing	Concept
easy listening	Concept
dubstep	Concept
musical arrangement	Concept
Judas Priest	Entity
power pop	Concept
Strauss	Entity
g√ºiro	Concept
wedding music	Concept
The Beyond	Entity
quintet	Concept
Fireworks	Entity
shawm	Concept
progressive	Concept
Goldfrapp	Entity
viola	Concept
radio shows	Concept
trad	Concept
preparation	Concept
serious music	Concept
