balsa raft	Concept
malfeasance	Concept
southwestward	Concept
management	Concept
Phi Sigma Pi	Entity
balance of power	Concept
Tomb Raider	Entity
flavin	Concept
rep	Concept
electorate	Concept
gradation	Concept
leveling	Concept
condition	Concept
pottery	Concept
pointer	Concept
Ian Bell	Entity
ghrelin	Concept
north	Concept
Joan Silber	Entity
reporter	Concept
liberalism	Concept
David T. Ellwood	Entity
Dejan Bodiroga	Entity
Before Dark	Entity
center	Concept
Scott White	Entity
pigweed	Concept
Apiaceae	Concept
Tutankhamun	Entity
Reckless Kelly	Entity
manslaughter	Concept
Whitaker	Entity
Antony Leung	Entity
ineptitude	Concept
Pyrrhus	Entity
palette	Concept
Seanad	Concept
medalist	Concept
dentist	Concept
umber	Concept
Greccio	Entity
close combat	Concept
hell	Concept
deposit	Concept
OpenOffice	Entity
Maryland	Entity
afterlife	Concept
Beijing	Entity
naturalist	Concept
Myrdal	Entity
