bass saxophone	Concept
Mackey Feary	Entity
pop	Concept
keyboardist	Concept
gramophone	Concept
The Clearing	Entity
light opera	Concept
The Cure	Entity
new jazz	Concept
cymbal	Concept
singsong	Concept
lyricist	Concept
gospel	Concept
zydeco	Concept
duet	Concept
Bob Dylan	Entity
Baker Street	Entity
Bedrock Records	Entity
turntablists	Concept
glissando	Concept
The Doldrums	Entity
vocal harmony	Concept
horn	Concept
celtic folk	Concept
pan flute	Concept
rock music	Concept
piano blues	Concept
Space Monkeys	Entity
Grappelli	Entity
country music	Concept
Supraphon	Entity
solmization	Concept
quartette	Concept
house	Concept
operettas	Concept
rave	Concept
drum cadence	Concept
love song	Concept
Angels Fall First	Entity
Stampede	Entity
masses	Concept
psytrance	Concept
pastoral	Concept
Nightshift	Entity
techno	Concept
crumhorn	Concept
polyphony	Concept
xylophone	Concept
Robert Cray	Entity
madrigal	Concept
funk	Concept
Steve Mackey	Entity
Whiskey Tango Ghosts	Entity
canon	Concept
golden oldie	Concept
Public Enemy	Entity
scottish folk	Concept
ambient	Concept
Kazimierz Serocki	Entity
doo wop	Concept
serenade	Concept
serial music	Concept
Some Kinda Rush	Entity
Group Therapy	Entity
chanting	Concept
Radiohead	Entity
Supernatural	Entity
gittern	Concept
Ramones	Entity
spoken word	Concept
baritone guitar	Concept
bugler	Concept
jump blues	Concept
trio sonata	Concept
Citysong	Entity
pibroch	Concept
tone poems	Concept
phrase	Concept
Kenny Loggins	Entity
continuo	Concept
piano sonata	Concept
Heartland rock	Concept
recitative	Concept
motet	Concept
ska punk	Concept
tune	Concept
postlude	Concept
opera	Concept
tributes	Concept
jaw harp	Concept
schottische	Concept
twelve-tone music	Concept
garage rock	Concept
Mikey Chung	Entity
Tom Waits	Entity
bolero	Concept
singer-songwriter	Concept
alphorn	Concept
ranchera	Concept
shoegazing	Concept
tom-tom	Concept
sing-a-longs	Concept
marching music	Concept
salsa	Concept
drum set	Concept
swing jazz	Concept
Krush	Entity
symphony	Concept
clapper	Concept
Elvis Costello	Entity
macumba	Concept
Beastie Boys	Entity
harmonica blues	Concept
coda	Concept
riff	Concept
program music	Concept
seven-string guitar	Concept
british invasion	Concept
Frank Sinatra	Entity
tenor tuba	Concept
score	Concept
kick drum	Concept
preparation	Concept
Queen	Entity
doo-wop	Concept
rap rock	Concept
Dizzy Gillespie	Entity
anticlimax	Concept
Björk	Entity
rainstick	Concept
grupero	Concept
pop music	Concept
Russian pop	Concept
Genesis	Entity
psalm	Concept
britpop	Concept
drinking song	Concept
glam rock	Concept
soul	Concept
New Order	Entity
James Brown	Entity
songbook	Concept
chamber music	Concept
Renaissance music	Concept
jive	Concept
Paul Stookey	Entity
Eminem	Entity
march	Concept
americana	Concept
bagatelle	Concept
fugues	Concept
melody	Concept
Fleetwood Mac	Entity
Joe Satriani	Entity
comedic music	Concept
odes	Concept
bass	Concept
rock-and-roll	Concept
Thornography	Entity
tenor drum	Concept
realisation	Concept
Whip My Hair	Entity
post-punk	Concept
Liz Phair	Entity
anthem	Concept
vihuela	Concept
bell lyre	Concept
autoharp	Concept
The Rolling Stones	Entity
Velvet Monkeys	Entity
cantata	Concept
recessional	Concept
zither	Concept
Sonic Youth	Entity
prelude	Concept
nocturnes	Concept
intonation	Concept
voices	Concept
contemporary big band	Concept
Mike Hickey	Entity
amplifier	Concept
misquote	Concept
ballads	Concept
Rolling Stones	Entity
Goldfrapp	Entity
hardcore	Concept
trad	Concept
obbligato	Concept
Shakey Ground	Entity
Grapevyne	Entity
Someday Came Suddenly	Entity
Yessongs	Entity
composition	Concept
east coast	Concept
Megadeth	Entity
Gittler guitar	Concept
vallenato	Concept
trumpet	Concept
sarabande	Concept
septet	Concept
gospel singing	Concept
latin music	Concept
Benny Goodman	Entity
musical	Concept
southern gospel	Concept
Lollipop	Entity
Duran Duran	Entity
tin pan alley	Concept
ska	Concept
movement	Concept
Brazilian rock	Concept
syncopation	Concept
instrumental	Concept
chanty	Concept
violoncello	Concept
capriccio	Concept
contemporary blues	Concept
rider	Concept
adult alternative	Concept
hymnody	Concept
quartet	Concept
emo	Concept
bongos	Concept
fiddle	Concept
kithara	Concept
pastiche	Concept
melodic line	Concept
french pop	Concept
glockenspiel	Concept
alto flute	Concept
jam bands	Concept
ukelele	Concept
soundtrack album	Concept
Lollipops and Roses	Entity
surf guitar	Concept
Dreamtime	Entity
hot jazz	Concept
Planningtorock	Entity
wedding music	Concept
mazurkas	Concept
oboe	Concept
My My	Entity
The Arrival	Entity
mallet	Concept
The Ventures	Entity
musical composition	Concept
book	Concept
slide	Concept
dance pop	Concept
opening	Concept
idm	Concept
arioso	Concept
trio	Concept
Back on Track	Entity
tuba	Concept
dithyramb	Concept
David Bisbal	Entity
blue-eyed soul	Concept
cool jazz	Concept
neotraditional	Concept
progressive metal	Concept
bongo drum	Concept
drums	Concept
Blue Monday	Entity
canticle	Concept
Depeche Mode	Entity
choir	Concept
Loaded	Entity
karaoke	Concept
Iron Maiden	Entity
Take Me Out	Entity
Heart Food	Entity
polonaise	Concept
cover song	Concept
celesta	Concept
piccolo trumpet	Concept
negro spiritual	Concept
Mute Print	Entity
musical drama	Concept
rocksteady	Concept
shanty	Concept
diminution	Concept
orchestral jazz	Concept
hip-hop	Concept
Blur	Entity
ostinato	Concept
Louis Armstrong	Entity
flageolet	Concept
preludes	Concept
theme	Concept
Carl Davis	Entity
symphonic music	Concept
Manners	Entity
traditional	Concept
Naked	Entity
Zeraphine	Entity
teen pop	Concept
excerpt	Concept
kalimba	Concept
flugelhorn	Concept
christmas	Concept
new jack	Concept
saxophone	Concept
bugle	Concept
Let It Be	Entity
preamble	Concept
Roar	Entity
vocal jazz	Concept
washboard	Concept
folk song	Concept
serious music	Concept
electric blues	Concept
texas blues	Concept
minuet	Concept
part	Concept
discant	Concept
backup	Concept
lead sheet	Concept
new age	Concept
reggaeton	Concept
allegro	Concept
The Ultimate	Entity
support	Concept
Dance-rock	Concept
riot grrl	Concept
blues	Concept
signature tune	Concept
potpourri	Concept
quintet	Concept
smooth jazz	Concept
maracas	Concept
Wu-Tang Clan	Entity
musical passage	Concept
orchestration	Concept
air	Concept
harmony	Concept
classic big band	Concept
Stravinsky	Entity
chorale	Concept
The Shins	Entity
Hot Mess	Entity
folk	Concept
quadrille	Concept
folk music	Concept
Artwork	Entity
Irma	Entity
alternative metal	Concept
obligato	Concept
Stevie Wonder	Entity
italian pop	Concept
rhumba	Concept
bop	Concept
Über	Entity
Frank Zappa	Entity
chanson	Concept
triangle	Concept
trip-hop	Concept
adagio	Concept
latin rock	Concept
traditional folk	Concept
Dance Revolution	Entity
habanera	Concept
The Crusade	Entity
threnody	Concept
mazurka	Concept
Stronger	Entity
orchestra	Concept
extract	Concept
canto	Concept
sheng	Concept
rap	Concept
dixieland	Concept
Paul McCartney	Entity
U2	Entity
piano	Concept
Summertime	Entity
Phil Collins	Entity
electric guitar	Concept
outlaw country	Concept
melodic phrase	Concept
grate	Concept
Russian guitar	Concept
Salvation	Entity
monody	Concept
old-time country	Concept
largo	Concept
easy listening	Concept
Edwin Birdsong	Entity
baroque pop	Concept
math rock	Concept
goth	Concept
David Foster	Entity
guitar gods	Concept
religious music	Concept
rap music	Concept
aria	Concept
rock and roll	Concept
country and western	Concept
invention	Concept
djembe	Concept
Ascendancy	Entity
reggae	Concept
suite	Concept
ligature	Concept
The Chariot	Entity
stride piano	Concept
lament	Concept
antiphon	Concept
preface	Concept
cacophony	Concept
sextets	Concept
boogie	Concept
british punk	Concept
black music	Concept
love-song	Concept
proto punk	Concept
Just Dance	Entity
r and b	Concept
melodic theme	Concept
plainsong	Concept
dirge	Concept
recital	Concept
caroling	Concept
baritone saxophone	Concept
Joy Division	Entity
steel drums	Concept
epigraph	Concept
Latin jazz	Concept
Trapped	Entity
musical bow	Concept
drum kit	Concept
transverse flute	Concept
radio shows	Concept
The Clovers	Entity
lieder	Concept
pedal	Concept
finger cymbals	Concept
hard rock	Concept
Katy Perry	Entity
classical music	Concept
epistle	Concept
swing	Concept
basso continuo	Concept
rumba	Concept
korean pop	Concept
tenor saxophone	Concept
west coast blues	Concept
rackett	Concept
whistling	Concept
chant	Concept
progressive	Concept
swing music	Concept
leitmotif	Concept
oldies	Concept
cabaret	Concept
Photograph	Entity
short form	Concept
samba	Concept
crwth	Concept
signature	Concept
shred	Concept
musical arrangement	Concept
Bounce	Entity
antiphonal	Concept
monochord	Concept
soft rock	Concept
finale	Concept
dance music	Concept
military march	Concept
The Beyond	Entity
Avatar	Entity
waltz	Concept
fantasia	Concept
voice part	Concept
punk	Concept
cumbia	Concept
bouffe	Concept
character piece	Concept
choral	Concept
Led Zeppelin	Entity
trombone	Concept
sheet music	Concept
The Velvet Underground	Entity
All Wrapped Up	Entity
octet	Concept
incidental music	Concept
indie rock	Concept
Lithuanian rock	Concept
musette	Concept
bachata	Concept
jangle pop	Concept
rock	Concept
rondo	Concept
lyre	Concept
tin whistle	Concept
Wagner	Entity
scherzo	Concept
clavichord	Concept
study	Concept
recorder	Concept
