Kenny Hickey	Entity
concerto	Concept
organ	Concept
contralto	Concept
rider	Concept
operetta	Concept
rebec	Concept
voice part	Concept
Neil Young	Entity
postlude	Concept
folk	Concept
bongo drums	Concept
Sister Ray	Entity
Paul McCartney	Entity
Joy Division	Entity
rainstick	Concept
impromptu	Concept
Genesis	Entity
death metal	Concept
Shamrock Diaries	Entity
character piece	Concept
Gittler guitar	Concept
Latin hip-hop	Concept
introit	Concept
The Rolling Stones	Entity
shawm	Concept
Like Drawing Blood	Entity
classical music	Concept
disco	Concept
twee pop	Concept
John Peel	Entity
post-punk	Concept
drumming	Concept
After the Storm	Entity
mazurkas	Concept
leitmotiv	Concept
celesta	Concept
gradual	Concept
bel canto	Concept
tone poems	Concept
motif	Concept
voice	Concept
traditional pop	Concept
celtic folk	Concept
crash cymbals	Concept
Mute Print	Entity
preludes	Concept
elegies	Concept
cantata	Concept
Public Enemy	Entity
gospel singing	Concept
prologue	Concept
fantasies	Concept
glissando	Concept
tango	Concept
love-song	Concept
adult alternative	Concept
intermezzo	Concept
negro spiritual	Concept
serial music	Concept
tambourine	Concept
thumb piano	Concept
Coil	Entity
tone poem	Concept
euro pop	Concept
Robert Cray	Entity
kickdrum	Concept
Up All Night	Entity
cantus firmus	Concept
finger cymbals	Concept
Pearl Jam	Entity
oratorio	Concept
sing-a-longs	Concept
bass part	Concept
riff	Concept
americana	Concept
southern rock	Concept
Cypress Hill	Entity
syncopation	Concept
vocal jazz	Concept
symphony	Concept
lo-fi	Concept
comedic music	Concept
Stravinsky	Entity
chant	Concept
british invasion	Concept
disney	Concept
symphonic poem	Concept
musical phrase	Concept
bass saxophone	Concept
art rock	Concept
straight edge	Concept
Dream Theater	Entity
Krush	Entity
variation	Concept
Planet Earth	Entity
coloratura	Concept
The Beyond	Entity
chorus	Concept
psychedelic rock	Concept
a cappella singing	Concept
timbales	Concept
Russian pop	Concept
conga	Concept
songstress	Concept
reel	Concept
seven-string guitar	Concept
plainsong	Concept
güiro	Concept
Bounce	Entity
backup	Concept
lullabies	Concept
singing	Concept
James Brown	Entity
Katy Perry	Entity
fugues	Concept
Loaded	Entity
new jack	Concept
power pop	Concept
saxophone	Concept
Baker Street	Entity
glockenspiel	Concept
Dreamtime	Entity
solo	Concept
musical composition	Concept
texas blues	Concept
My Bloody Valentine	Entity
roots rock	Concept
Mackey Feary	Entity
cool jazz	Concept
panpipes	Concept
conductor	Concept
salutation	Concept
polonaise	Concept
preface	Concept
Bruce Springsteen	Entity
vocal	Concept
macumba	Concept
David Foster	Entity
electronic pop	Concept
antiphon	Concept
bass	Concept
nocturnes	Concept
vallenato	Concept
work song	Concept
gregorian chant	Concept
Prince	Entity
Space Monkeys	Entity
garage rock	Concept
chanty	Concept
minstrelsy	Concept
Wrapped Around	Entity
sonatina	Concept
military march	Concept
extract	Concept
Antichrist Superstar	Entity
Quincy Jones	Entity
classic rock	Concept
ballet	Concept
karaoke	Concept
Latin jazz	Concept
instrumental music	Concept
odes	Concept
Trap House	Entity
Grapevyne	Entity
French rock	Concept
Eurythmics	Entity
Pink Floyd	Entity
contemporary folk	Concept
mezzo-soprano	Concept
baritone guitar	Concept
Trapped	Entity
Pakistani rock	Concept
waltz	Concept
harmonization	Concept
Fireworks	Entity
Your Favorite Weapon	Entity
bugle	Concept
alto clarinet	Concept
vocal harmony	Concept
instrumentation	Concept
southern gospel	Concept
pastorale	Concept
andante	Concept
steel drums	Concept
opera	Concept
alternative metal	Concept
tenor	Concept
Boy George	Entity
symphonic music	Concept
lyricist	Concept
marching music	Concept
trance	Concept
Tom Waits	Entity
voices	Concept
cowboy	Concept
Pavarotti	Entity
basso continuo	Concept
serious music	Concept
Rockfest	Entity
blues	Concept
ballroom music	Concept
Fursaxa	Entity
The Beach Boys	Entity
vocal music	Concept
lied	Concept
religious song	Concept
musical theme	Concept
harmony	Concept
quartet	Concept
flourish	Concept
neo-soul	Concept
duet	Concept
Annie Lennox	Entity
guitar	Concept
experimental rap	Concept
The Doldrums	Entity
bop	Concept
counterpoint	Concept
idyll	Concept
Frank Sinatra	Entity
Telegraph Road	Entity
proto punk	Concept
post hardcore	Concept
alphorn	Concept
David Bisbal	Entity
harmonica	Concept
clavichord	Concept
ballads	Concept
arena rock	Concept
baritone saxophone	Concept
rockabilly	Concept
trio	Concept
Brian Wilson	Entity
musical bow	Concept
Jim O'Rourke	Entity
latin music	Concept
Goldfrapp	Entity
goth	Concept
Fleetwood Mac	Entity
cittern	Concept
marimba	Concept
oboe	Concept
playback	Concept
Black Sabbath	Entity
Ascendancy	Entity
alto flute	Concept
The Crusade	Entity
Rolling Stones	Entity
disco music	Concept
hardcore	Concept
anticlimax	Concept
antiphonary	Concept
antiphony	Concept
jamaican ska	Concept
lieder	Concept
west coast	Concept
sextet	Concept
claves	Concept
violin	Concept
cymbal	Concept
fugue	Concept
The Reeling	Entity
aria	Concept
Let It Be	Entity
bugler	Concept
madrigal	Concept
Blue Monday	Entity
Art of Life	Entity
gospel	Concept
operettas	Concept
flute	Concept
tubular bells	Concept
christmas carol	Concept
train whistle	Concept
The Ventures	Entity
cutting	Concept
smooth jazz	Concept
signature	Concept
metal	Concept
chimes	Concept
Agoraphobia	Entity
ukelele	Concept
X Japan	Entity
bagpipe	Concept
surf rock	Concept
Fidelio	Entity
Kiss	Entity
Artwork	Entity
Angela McCluskey	Entity
west coast blues	Concept
tributes	Concept
Queen	Entity
Celtic rock	Concept
Damnation	Entity
Miles Davis	Entity
funk rock	Concept
carioca	Concept
morceau	Concept
dixieland	Concept
Nine Inch Nails	Entity
military music	Concept
blue-eyed soul	Concept
vocal blues	Concept
classic big band	Concept
soul	Concept
Shakey Ground	Entity
Deep Purple	Entity
clapper	Concept
Renaissance music	Concept
trombone	Concept
rock-and-roll	Concept
divertimento	Concept
triangle	Concept
rag	Concept
gigue	Concept
cover song	Concept
quintet	Concept
leitmotif	Concept
rock	Concept
fantasia	Concept
bagatelle	Concept
Madonna	Entity
improvisation	Concept
surf guitar	Concept
Thornography	Entity
dub	Concept
Summertime	Entity
dulcimer	Concept
partita	Concept
wedding music	Concept
ranchera	Concept
electronica	Concept
tenor tuba	Concept
adagio	Concept
hornpipe	Concept
guitar gods	Concept
electric blues	Concept
gavotte	Concept
piano sonata	Concept
acid rock	Concept
folk music	Concept
ambient	Concept
monophony	Concept
foreword	Concept
Paint It Black	Entity
lyre	Concept
singer-songwriter	Concept
monochord	Concept
invention	Concept
Phil Collins	Entity
urban folk	Concept
orchestral jazz	Concept
potpourri	Concept
Brazilian rock	Concept
Grateful Dead	Entity
Whiskey Tango Ghosts	Entity
neotraditional	Concept
Dark Passion Play	Entity
recessional	Concept
primo	Concept
Handbags and Gladrags	Entity
minuet	Concept
Never Say Die	Entity
Supraphon	Entity
ska punk	Concept
jangle pop	Concept
All Wrapped Up	Entity
slide	Concept
Radiohead	Entity
drum set	Concept
modern blues	Concept
Ilosaarirock	Entity
baton	Concept
Citysong	Entity
epilogue	Concept
Manners	Entity
boogie-woogie	Concept
singalong	Concept
reharmonization	Concept
Gentle Giant	Entity
Dance-rock	Concept
djembe	Concept
Live Forever	Entity
Back on Track	Entity
american alternative	Concept
The Chariot	Entity
grate	Concept
Beastie Boys	Entity
Ira D. Sankey	Entity
Elvis Presley	Entity
harmonium	Concept
Mike Hickey	Entity
quotation	Concept
kalimba	Concept
ocarina	Concept
bassoon	Concept
alternative rock	Concept
flamenco	Concept
horn	Concept
acoustic blues	Concept
glam	Concept
punk	Concept
cadenza	Concept
soundtrack	Concept
brazilian jazz	Concept
Lose My Breath	Entity
golden oldie	Concept
octet	Concept
The Velvet Underground	Entity
harp	Concept
drum kit	Concept
score	Concept
Megadeth	Entity
microphone	Concept
Taiwanese pop	Concept
Liz Phair	Entity
melodic line	Concept
contrabassoon	Concept
cantillation	Concept
world dance	Concept
Heartland rock	Concept
recital	Concept
Iris	Entity
Yes	Entity
traditional blues	Concept
riot grrl	Concept
capriccio	Concept
punk revival	Concept
Benny Goodman	Entity
temple blocks	Concept
Basket Case	Entity
yodeling	Concept
Motörhead	Entity
Lollipop	Entity
national anthem	Concept
barcarolle	Concept
musical	Concept
pop metal	Concept
old-time country	Concept
punk rock	Concept
Tony Brock	Entity
Planningtorock	Entity
My Chemical Romance	Entity
british punk	Concept
Eminem	Entity
jam bands	Concept
masses	Concept
Yoshiki	Entity
soprano saxophone	Concept
continuo	Concept
vibraphone	Concept
nocturne	Concept
Silverthorn	Entity
doo-wop	Concept
whistling	Concept
drum & bass	Concept
musical harmony	Concept
Indorock	Entity
Jimi Hendrix	Entity
monody	Concept
Nightshift	Entity
american punk	Concept
My My	Entity
clarinet	Concept
maracas	Concept
bachata	Concept
irish folk	Concept
swing music	Concept
autoharp	Concept
outlaw country	Concept
cacophony	Concept
rumba	Concept
mariachi	Concept
antiphonal	Concept
piano blues	Concept
alto saxophone	Concept
Stronger	Entity
tarantella	Concept
Some Kinda Rush	Entity
figured bass	Concept
duo	Concept
musical arrangement	Concept
Wagner	Entity
chamber music	Concept
sousaphone	Concept
Charlotte Church	Entity
The Arrival	Entity
lullaby	Concept
gramophone	Concept
paean	Concept
Dave Brockie	Entity
bouffe	Concept
allegro	Concept
polka	Concept
Nas	Entity
Chamberlin	Entity
The Prodigy	Entity
scat	Concept
vamp	Concept
